N-HSEA	&
N-H*IE	--
N-HS*O	Return
-A	a
-AJ	ai
-AT	am
-AN	an
-AG	ang
-AK	anh
-AJK	ao
-AJG	au
STR-A	ba
STR-AJ	bai
STR-AN	ban
STR-AG	bang
STR-AK	banh
STR-AJK	bao
STR-AJN	bay
STR-E	be
STR-ET	bem
STR-EN	ben
STR-EG	beng
STR-EJK	beo
STR*-I	bi
STR-IE	bia
STR*-IN	bin
STR*-IK	binh
STR-IEN	biên
STR-SIENK	biếc
STR-SIET	biếm
STR-SIEN	biến
STR-SIEG	biếng
STR-SIENT	biết
STR-SIEJG	biếu
STR-HIEN	biền
STR-HSIEN	biển
STR-HSIEJG	biểu
STRN-IEN	biện
STRN-IENT	biệt
STR-O	bo
STR-U	boa
STR-OT	bom
STR-ON	bon
STR-OG	bong
STR*-OG	boong
STR-IU	bu
STR-UO	bua
STR-IUG	bung
STR-UON	buôn
STR-UOG	buông
STR-SUYNT	buýt
STR-SUONT	buốt
STR-HUOJ	buồi
STR-HUOT	buồm
STR-HUON	buồn
STR-HUOG	buồng
STR-HSUOJ	buổi
STRN-UONK	buộc
STRN-UOJ	buội
STRN-UOT	buộm
STRN-UONT	buột
STR-HA	bà
STR-HAJ	bài
STR-HAN	bàn
STR-HAG	bàng
STR-HAK	bành
STR-HAJK	bào
STR-HAJG	bàu
STR-HAJN	bày
STR-SA	bá
STR-SANK	bác
STR-SAGK	bách
STR-SAJ	bái
STR-SAT	bám
STR-SAN	bán
STR-SAG	báng
STR-SAK	bánh
STR-SAJK	báo
STR-SANT	bát
STR-SAJG	báu
STR*-EN	bân
STR*-EG	bâng
STR*-EJG	bâu
STR*-EJN	bây
STRN-SA	bã
STRN-SAJ	bãi
STRN-SAJK	bão
STR-HE	bè
STR-HET	bèm
STR-HEN	bèn
STR-HEJK	bèo
STR-SE	bé
STR-SENK	béc
STR-SEN	bén
STR-SEG	béng
STR-SEJK	béo
STR-SETK	bép
STR-SENT	bét
STR-OE	bê
STR-OEN	bên
STR-OEK	bênh
STR-OEJG	bêu
STR-H*I	bì
STR-HIE	bìa
STR-H*IT	bìm
STR-H*IK	bình
STR-H*IJG	bìu
STR-S*I	bí
STR-S*IGK	bích
STR-S*IT	bím
STR-S*IK	bính
STR-S*ITK	bíp
STR-S*INT	bít
STR-S*IJG	bíu
STR-HO	bò
STR-HON	bòn
STR-HOG	bòng
STR-SO	bó
STR-SONK	bóc
STR-SOJ	bói
STR-SOT	bóm
STR-SON	bón
STR-SOG	bóng
STR-SOTK	bóp
STR-SONT	bót
STR-OA	bô
STR-OAJ	bôi
STR-OAT	bôm
STR-OAN	bôn
STR-OAG	bông
STRN-SO	bõ
STRN-SOT	bõm
STRN-SOG	bõng
STR-HIU	bù
STR-HUO	bùa
STR-HIUJ	bùi
STR-HIUT	bùm
STR-HIUN	bùn
STR-HIUG	bùng
STR-SIU	bú
STR-SUO	búa
STR-SIUJ	búi
STR-SIUN	bún
STR-SIUG	búng
STR-SIUTK	búp
STR-SIUNT	bút
STR*-AT	băm
STR*-AN	băn
STR*-AG	băng
STRN-S*I	bĩ
STRN-S*IK	bĩnh
STRN-S*IJG	bĩu
STR-OY	bơ
STR-OYJ	bơi
STR-OYT	bơm
STR-OYN	bơn
STR-UAG	bưng
STR-UAJG	bưu
STR-EAJ	bươi
STR-EAT	bươm
STR-EAN	bươn
STR-EAG	bương
STR-EAJG	bươu
STR-SEANK	bước
STR-SEAT	bướm
STR-SEAG	bướng
STR-SEATK	bướp
STR-SEAJG	bướu
STR-HSEAJ	bưởi
STRN-A	bạ
STRN-ANK	bạc
STRN-AGK	bạch
STRN-AJ	bại
STRN-AN	bạn
STRN-AG	bạng
STRN-AK	bạnh
STRN-AJK	bạo
STRN-ATK	bạp
STRN-ANT	bạt
STRN-AJG	bạu
STR-HSA	bả
STR-HSAJ	bải
STR-HSAN	bản
STR-HSAG	bảng
STR-HSAK	bảnh
STR-HSAJK	bảo
STR-HSAJG	bảu
STR-HSAJN	bảy
STR-S*ENK	bấc
STR-S*ET	bấm
STR-S*EN	bấn
STR-S*EG	bấng
STR-S*ETK	bấp
STR-S*ENT	bất
STR-S*EJG	bấu
STR-S*EJN	bấy
STR-H*ET	bầm
STR-H*EN	bần
STR-H*EJG	bầu
STR-H*EJN	bầy
STR-HS*ET	bẩm
STR-HS*EN	bẩn
STR-HS*EJG	bẩu
STR-HS*EJN	bẩy
STRN-S*ET	bẫm
STRN-S*EG	bẫng
STRN-S*EJN	bẫy
STRN*-ENK	bậc
STRN*-ET	bậm
STRN*-EN	bận
STRN*-ETK	bập
STRN*-ENT	bật
STRN*-EJG	bậu
STRN*-EJN	bậy
STR-S*ANK	bắc
STR-S*AN	bắn
STR-S*AG	bắng
STR-S*ATK	bắp
STR-S*ANT	bắt
STR-H*AT	bằm
STR-H*AN	bằn
STR-H*AG	bằng
STR-HS*AT	bẳm
STR-HS*AN	bẳn
STRN-S*AT	bẵm
STRN-S*AG	bẵng
STRN*-ANK	bặc
STRN*-AT	bặm
STRN*-AN	bặn
STRN*-AG	bặng
STRN*-ATK	bặp
STRN*-ANT	bặt
STRN-E	bẹ
STRN-ENK	bẹc
STRN-EN	bẹn
STRN-EJK	bẹo
STRN-ETK	bẹp
STRN-ENT	bẹt
STR-HSE	bẻ
STR-HSET	bẻm
STR-HSEJK	bẻo
STRN-SE	bẽ
STRN-SEN	bẽn
STRN-SEJK	bẽo
STR-SOE	bế
STR-SOEN	bến
STR-SOETK	bếp
STR-SOENT	bết
STR-SOEJG	bếu
STR-HOE	bề
STR-HOEN	bền
STR-HOEK	bềnh
STR-HOEJG	bều
STR-HSOE	bể
STR-HSOEN	bển
STRN-SOE	bễ
STRN-OE	bệ
STRN-OEGK	bệch
STRN-OEN	bện
STRN-OEK	bệnh
STRN-OENT	bệt
STRN-OEJG	bệu
STR-HS*I	bỉ
STR-HS*IK	bỉnh
STR-HS*IJG	bỉu
STRN*-I	bị
STRN-IE	bịa
STRN*-IGK	bịch
STRN*-IN	bịn
STRN*-IK	bịnh
STRN*-ITK	bịp
STRN*-INT	bịt
STRN*-IJG	bịu
STRN-O	bọ
STRN-ONK	bọc
STRN-ON	bọn
STRN-OG	bọng
STRN-ONT	bọt
STR-HSO	bỏ
STR-HSOJ	bỏi
STR-HSOT	bỏm
STR-HSOG	bỏng
STR-SOA	bố
STR-SOANK	bốc
STR-SOAJ	bối
STR-SOAN	bốn
STR-SOAG	bống
STR-SOATK	bốp
STR-SOANT	bốt
STR-HOA	bồ
STR-HOAJ	bồi
STR-HOAT	bồm
STR-HOAN	bồn
STR-HOAG	bồng
STR-HSOA	bổ
STR-HSOAJ	bổi
STR-HSOAN	bổn
STR-HSOAG	bổng
STRN-SOA	bỗ
STRN-SOAJ	bỗi
STRN-SOAG	bỗng
STRN-OA	bộ
STRN-OANK	bộc
STRN-OAJ	bội
STRN-OAN	bộn
STRN-OAG	bộng
STRN-OATK	bộp
STRN-OANT	bột
STR-SOY	bớ
STR-SOYJ	bới
STR-SOYTK	bớp
STR-SOYNT	bớt
STR-HOY	bờ
STR-HOYJ	bời
STR-HOYT	bờm
STR-HSOY	bở
STR-HSOYJ	bởi
STRN-SOY	bỡ
STRN-SOYN	bỡn
STRN-OY	bợ
STRN-OYT	bợm
STRN-OYN	bợn
STRN-OYTK	bợp
STRN-OYNT	bợt
STRN-IU	bụ
STRN-UO	bụa
STRN-IUNK	bục
STRN-IUJ	bụi
STRN-IUT	bụm
STRN-IUG	bụng
STRN-IUTK	bụp
STRN-IUNT	bụt
STR-HSIU	bủ
STR-HSUO	bủa
STR-HSIUN	bủn
STR-HSIUG	bủng
STR-SUA	bứ
STR-SEA	bứa
STR-SUANK	bức
STR-SUAG	bứng
STR-SUANT	bứt
STR-HEA	bừa
STR-HUAG	bừng
STR-HSEA	bửa
STR-HSUAG	bửng
STR-HSUAJG	bửu
STRN-SEA	bữa
STRN-UA	bự
STRN-EA	bựa
STRN-UANK	bực
STRN-UAG	bựng
STRN-UANT	bựt
K-A	ca
K-AJ	cai
K-AT	cam
K-AN	can
K-AG	cang
K-AK	canh
K-AJK	cao
K-AJG	cau
K-AJN	cay
SK-A	cha
SK-AJ	chai
SK-AN	chan
SK-AG	chang
SK-AK	chanh
SK-AJK	chao
SK-AJG	chau
SK-AJN	chay
SK-E	che
SK-EN	chen
SK-EG	cheng
SK-EJK	cheo
SK*-I	chi
SK-IE	chia
SK*-IT	chim
SK*-IK	chinh
SK*-IJG	chiu
SK-IET	chiêm
SK-IEN	chiên
SK-IEG	chiêng
SK-IEJG	chiêu
SK-SIENK	chiếc
SK-SIET	chiếm
SK-SIEN	chiến
SK-SIEG	chiếng
SK-SIETK	chiếp
SK-SIENT	chiết
SK-SIEJG	chiếu
SK-HIEN	chiền
SK-HIEG	chiềng
SK-HIEJG	chiều
SK-HSIEJG	chiểu
SKN-IEN	chiện
SK-O	cho
SK-U	choa
SK-UJ	choai
SK-UG	choang
SK-AY	choe
SK-AYN	choen
SK-OJ	choi
SK-ON	chon
SK-OG	chong
SK-HUJ	choài
SK-HUG	choàng
SK-HUK	choành
SK-SU	choá
SK-SUNK	choác
SK-SUGK	choách
SK-SUJ	choái
SK-SUN	choán
SK-SUG	choáng
SKN-SUJ	choãi
SK-HAY	choè
SK-HAYN	choèn
SK-SAY	choé
SK-SAYNT	choét
SKN-UNK	choạc
SKN-UGK	choạch
SKN-UJ	choại
SKN-UG	choạng
SK-HSUG	choảng
SK-S*UNT	choắt
SKN-AY	choẹ
SKN-AYNT	choẹt
SK-IU	chu
SK-UO	chua
SK-IUJ	chui
SK-IUT	chum
SK-IUN	chun
SK-IUG	chung
SK-EYN	chuyên
SK-SEYN	chuyến
SK-HEYN	chuyền
SK-HSEYN	chuyển
SKN-EYN	chuyện
SK-UOJ	chuôi
SK-UOT	chuôm
SK-UOG	chuông
SK-HS*YN	chuẩn
SK-SUEK	chuếnh
SKN-UEGK	chuệch
SKN-UEK	chuệnh
SK-SUONK	chuốc
SK-SUOJ	chuối
SK-SUONT	chuốt
SK-HUOJ	chuồi
SK-HUON	chuồn
SK-HUOG	chuồng
SKN-SUOJ	chuỗi
SKN-UONK	chuộc
SKN-UOJ	chuội
SKN-UOG	chuộng
SKN-UONT	chuột
SK-HUY	chuỳ
SK-HA	chà
SK-HAJ	chài
SK-HAT	chàm
SK-HAG	chàng
SK-HAK	chành
SK-HAJK	chào
SK-HAJN	chày
SK-SA	chá
SK-SANK	chác
SK-SAGK	chách
SK-SAJ	chái
SK-SAN	chán
SK-SAG	cháng
SK-SAK	chánh
SK-SAJK	cháo
SK-SANT	chát
SK-SAJG	cháu
SK-SAJN	cháy
SK*-ET	châm
SK*-EN	chân
SK*-EG	châng
SK*-EJG	châu
SK*-EJN	chây
SKN-SA	chã
SKN-SAJ	chãi
SKN-SAJK	chão
SK-HE	chè
SK-HET	chèm
SK-HEN	chèn
SK-HEJK	chèo
SK-SE	ché
SK-SET	chém
SK-SEN	chén
SK-SEJK	chéo
SK-SETK	chép
SK-SENT	chét
SK-OE	chê
SK-OET	chêm
SK-OEK	chênh
SK-H*I	chì
SK-HIE	chìa
SK-H*IT	chìm
SK-H*IK	chình
SK-S*I	chí
SK-S*IGK	chích
SK-S*IT	chím
SK-S*IN	chín
SK-S*IK	chính
SK-S*ITK	chíp
SK-S*INT	chít
SK-S*IJG	chíu
SK-HO	chò
SK-HOJ	chòi
SK-HOT	chòm
SK-HOG	chòng
SK-SO	chó
SK-SONK	chóc
SK-SOJ	chói
SK-SOT	chóm
SK-SOG	chóng
SK-SOTK	chóp
SK-SONT	chót
SK-OAT	chôm
SK-OAN	chôn
SK-OAG	chông
SKN-SO	chõ
SKN-SOT	chõm
SKN-SOG	chõng
SK-HIU	chù
SK-HUO	chùa
SK-HIUJ	chùi
SK-HIUT	chùm
SK-HIUN	chùn
SK-HIUG	chùng
SK-SIU	chú
SK-SUO	chúa
SK-SIUNK	chúc
SK-SIUJ	chúi
SK-SIUT	chúm
SK-SIUG	chúng
SK-SIUNT	chút
SK*-AT	chăm
SK*-AN	chăn
SK*-AG	chăng
SKN-SIE	chĩa
SKN-S*IN	chĩn
SKN-S*IK	chĩnh
SKN-SIU	chũ
SKN-SIUJ	chũi
SKN-SIUT	chũm
SKN-SIUN	chũn
SK-OY	chơ
SK-OYJ	chơi
SK-OYT	chơm
SK-OYN	chơn
SK-UA	chư
SK-EA	chưa
SK-UAG	chưng
SK-EAG	chương
SK-SEANK	chước
SK-SEAG	chướng
SK-HEAT	chườm
SK-HEAG	chường
SK-HSEAG	chưởng
SKN-SEAG	chưỡng
SKN-EANK	chược
SKN-EATK	chượp
SKN-A	chạ
SKN-ANK	chạc
SKN-AGK	chạch
SKN-AT	chạm
SKN-AN	chạn
SKN-AG	chạng
SKN-AK	chạnh
SKN-AJK	chạo
SKN-ATK	chạp
SKN-ANT	chạt
SKN-AJN	chạy
SK-HSA	chả
SK-HSAJ	chải
SK-HSAJK	chảo
SK-HSAJG	chảu
SK-HSAJN	chảy
SK-S*ET	chấm
SK-S*EN	chấn
SK-S*ETK	chấp
SK-S*ENT	chất
SK-S*EJG	chấu
SK-S*EJN	chấy
SK-H*ET	chầm
SK-H*EN	chần
SK-H*EJG	chầu
SK-H*EJN	chầy
SK-HS*ET	chẩm
SK-HS*EN	chẩn
SK-HS*EJG	chẩu
SKN-S*ET	chẫm
SKN-S*EJG	chẫu
SKN*-ENK	chậc
SKN*-ET	chậm
SKN*-EN	chận
SKN*-ETK	chập
SKN*-ENT	chật
SKN*-EJG	chậu
SK-S*ANK	chắc
SK-S*AT	chắm
SK-S*AN	chắn
SK-S*ATK	chắp
SK-S*ANT	chắt
SK-H*AT	chằm
SK-H*AN	chằn
SK-H*AG	chằng
SK-HS*AG	chẳng
SKN-S*AN	chẵn
SKN*-ANK	chặc
SKN*-AT	chặm
SKN*-AN	chặn
SKN*-AG	chặng
SKN*-ATK	chặp
SKN*-ANT	chặt
SKN-EN	chẹn
SKN-EJK	chẹo
SKN-ENT	chẹt
SK-HSE	chẻ
SK-HSEG	chẻng
SK-HSEJK	chẻo
SKN-SE	chẽ
SKN-SEN	chẽn
SK-SOE	chế
SK-SOEGK	chếch
SK-SOEK	chếnh
SK-SOENT	chết
SK-HOE	chề
SK-HOEK	chềnh
SK-HSOEK	chểnh
SKN-SOET	chễm
SKN-SOEK	chễnh
SKN-OE	chệ
SKN-OEGK	chệch
SKN-OEN	chện
SKN-OEK	chệnh
SK-HS*I	chỉ
SK-HS*IN	chỉn
SK-HS*IK	chỉnh
SKN*-I	chị
SKN-IE	chịa
SKN*-INT	chịt
SKN*-IJG	chịu
SKN-ONK	chọc
SKN-OJ	chọi
SKN-OT	chọm
SKN-ON	chọn
SKN-ONT	chọt
SK-HSO	chỏ
SK-HSOJ	chỏi
SK-HSOT	chỏm
SK-HSON	chỏn
SK-HSOG	chỏng
SK-SOANK	chốc
SK-SOAJ	chối
SK-SOAN	chốn
SK-SOAG	chống
SK-SOATK	chốp
SK-SOANT	chốt
SK-HOA	chồ
SK-HOAJ	chồi
SK-HOAT	chồm
SK-HOAN	chồn
SK-HOAG	chồng
SK-HSOAJ	chổi
SK-HSOAT	chổm
SK-HSOAG	chổng
SKN-SOA	chỗ
SKN-SOAJ	chỗi
SKN-SOAT	chỗm
SKN-OA	chộ
SKN-OAJ	chội
SKN-OAN	chộn
SKN-OATK	chộp
SKN-OANT	chột
SK-SOY	chớ
SK-SOYJ	chới
SK-SOYT	chớm
SK-SOYN	chớn
SK-SOYTK	chớp
SK-SOYNT	chớt
SK-HOY	chờ
SK-HOYT	chờm
SK-HOYN	chờn
SK-HSOY	chở
SK-HSOYT	chởm
SKN-OY	chợ
SKN-OYN	chợn
SKN-OYTK	chợp
SKN-OYNT	chợt
SKN-IUNK	chục
SKN-IUT	chụm
SKN-IUTK	chụp
SKN-IUNT	chụt
SK-HSIU	chủ
SK-HSIUN	chủn
SK-HSIUG	chủng
SK-SUA	chứ
SK-SEA	chứa
SK-SUANK	chức
SK-SUAG	chứng
SK-HUA	chừ
SK-HEA	chừa
SK-HUAG	chừng
SK-HSEA	chửa
SK-HSUAJ	chửi
SK-HSUAG	chửng
SKN-SUA	chữ
SKN-SEA	chữa
SKN-SUAG	chững
SKN-UANK	chực
SKN-UAG	chựng
K-O	co
K-OJ	coi
K-OT	com
K-ON	con
K-OG	cong
K-IU	cu
K-UO	cua
K-IUJ	cui
K-IUT	cum
K-IUN	cun
K-IUG	cung
K-UOG	cuông
K-SUONK	cuốc
K-SUOJ	cuối
K-SUON	cuốn
K-SUOG	cuống
K-HUON	cuồn
K-HUOG	cuồng
KN-SUOT	cuỗm
KN-UONK	cuộc
KN-UOJ	cuội
KN-UON	cuộn
KN-UOG	cuộng
K-HA	cà
K-HAJ	cài
K-HAT	càm
K-HAN	càn
K-HAG	càng
K-HAK	cành
K-HAJK	cào
K-HAJG	càu
K-HAJN	cày
K-SA	cá
K-SANK	các
K-SAGK	cách
K-SAJ	cái
K-SAT	cám
K-SAN	cán
K-SAG	cáng
K-SAK	cánh
K-SAJK	cáo
K-SATK	cáp
K-SANT	cát
K-SAJG	cáu
K-SAJN	cáy
K*-ET	câm
K*-EN	cân
K*-EG	câng
K*-EJG	câu
K*-EJN	cây
KN-SAJ	cãi
K-HO	cò
K-HOJ	còi
K-HOT	còm
K-HON	còn
K-HOG	còng
K-SO	có
K-SONK	cóc
K-SOJ	cói
K-SOT	cóm
K-SON	cón
K-SOG	cóng
K-SOTK	cóp
K-SONT	cót
K-OA	cô
K-OAJ	côi
K-OAT	côm
K-OAN	côn
K-OAG	công
KN-SOJ	cõi
KN-SOT	cõm
KN-SOG	cõng
K-HIU	cù
K-HIUJ	cùi
K-HIUT	cùm
K-HIUN	cùn
K-HIUG	cùng
K-SIU	cú
K-SIUNK	cúc
K-SIUJ	cúi
K-SIUT	cúm
K-SIUN	cún
K-SIUG	cúng
K-SIUTK	cúp
K-SIUNT	cút
K*-AT	căm
K*-AN	căn
K*-AG	căng
KN-SIU	cũ
KN-SIUJ	cũi
KN-SIUN	cũn
KN-SIUG	cũng
K-OY	cơ
K-OYJ	cơi
K-OYT	cơm
K-OYN	cơn
K-UA	cư
K-EA	cưa
K-UAG	cưng
K-UAJG	cưu
K-EAG	cương
K-SEANK	cước
K-SEAJ	cưới
K-SEATK	cướp
K-HEAJ	cười
K-HEAT	cườm
K-HEAG	cường
KN-SEAJ	cưỡi
KN-SEAG	cưỡng
KN-EANK	cược
KN-A	cạ
KN-ANK	cạc
KN-AGK	cạch
KN-AT	cạm
KN-AN	cạn
KN-AK	cạnh
KN-AJK	cạo
KN-ATK	cạp
KN-AJG	cạu
KN-AJN	cạy
K-HSA	cả
K-HSAJ	cải
K-HSAT	cảm
K-HSAN	cản
K-HSAG	cảng
K-HSAK	cảnh
K-HSAJK	cảo
K-HSAJG	cảu
K-S*ENK	cấc
K-S*ET	cấm
K-S*EN	cấn
K-S*ETK	cấp
K-S*ENT	cất
K-S*EJG	cấu
K-S*EJN	cấy
K-H*ET	cầm
K-H*EN	cần
K-H*EJG	cầu
K-H*EJN	cầy
K-HS*ET	cẩm
K-HS*EN	cẩn
K-HS*EG	cẩng
K-HS*EJG	cẩu
KN-S*ET	cẫm
KN-S*EN	cẫn
KN-S*EG	cẫng
KN*-EN	cận
KN*-ETK	cập
KN*-ENT	cật
KN*-EJG	cậu
KN*-EJN	cậy
K-S*ANK	cắc
K-S*AT	cắm
K-S*AN	cắn
K-S*ATK	cắp
K-S*ANT	cắt
K-H*AT	cằm
K-H*AN	cằn
K-HS*AN	cẳn
K-HS*AG	cẳng
KN*-ANK	cặc
KN*-AT	cặm
KN*-AN	cặn
KN*-ATK	cặp
KN*-ANT	cặt
KN-O	cọ
KN-ONK	cọc
KN-OJ	cọi
KN-OT	cọm
KN-ON	cọn
KN-OG	cọng
KN-OTK	cọp
KN-ONT	cọt
K-HSO	cỏ
K-HSOJ	cỏi
K-HSOT	cỏm
K-HSON	cỏn
K-SOA	cố
K-SOANK	cốc
K-SOAJ	cối
K-SOAT	cốm
K-SOAN	cốn
K-SOAG	cống
K-SOATK	cốp
K-SOANT	cốt
K-HOA	cồ
K-HOAJ	cồi
K-HOAT	cồm
K-HOAN	cồn
K-HOAG	cồng
K-HSOA	cổ
K-HSOAJ	cổi
K-HSOAT	cổm
K-HSOAN	cổn
K-HSOAG	cổng
KN-SOA	cỗ
KN-SOAJ	cỗi
KN-OA	cộ
KN-OANK	cộc
KN-OAJ	cội
KN-OAT	cộm
KN-OAN	cộn
KN-OAG	cộng
KN-OATK	cộp
KN-OANT	cột
K-SOY	cớ
K-SOYT	cớm
K-SOYN	cớn
K-SOYNT	cớt
K-HOY	cờ
K-HOYJ	cời
K-HSOYJ	cởi
KN-SOY	cỡ
KN-SOYJ	cỡi
KN-SOYT	cỡm
KN-SOYN	cỡn
KN-OYT	cợm
KN-OYN	cợn
KN-OYTK	cợp
KN-OYNT	cợt
KN-IU	cụ
KN-IUNK	cục
KN-IUJ	cụi
KN-IUT	cụm
KN-IUG	cụng
KN-IUTK	cụp
KN-IUNT	cụt
K-HSIU	củ
K-HSUO	của
K-HSIUJ	củi
K-HSIUT	củm
K-HSIUN	củn
K-HSIUG	củng
K-SUA	cứ
K-SEA	cứa
K-SUANK	cức
K-SUAG	cứng
K-SUANT	cứt
K-SUAJG	cứu
K-HUA	cừ
K-HUAJG	cừu
K-HSUA	cử
K-HSEA	cửa
K-HSUAJ	cửi
K-HSUAJG	cửu
KN-SUA	cữ
KN-SUAJG	cữu
KN-UA	cự
KN-EA	cựa
KN-UANK	cực
KN-UAJG	cựu
SKR-A	da
SKR-AJ	dai
SKR-AT	dam
SKR-AN	dan
SKR-AG	dang
SKR-AK	danh
SKR-AJK	dao
SKR-AJN	day
SKR-E	de
SKR-EN	den
SKR-EJK	deo
SKR*-I	di
SKR*-IT	dim
SKR*-IN	din
SKR*-IK	dinh
SKR-IET	diêm
SKR-IEN	diên
SKR-IEJG	diêu
SKR-SIENK	diếc
SKR-SIET	diếm
SKR-SIETK	diếp
SKR-SIENT	diết
SKR-SIEJG	diếu
SKR-HIET	diềm
SKR-HIEG	diềng
SKR-HIEJG	diều
SKRN-SIET	diễm
SKRN-SIEN	diễn
SKRN-SIEJG	diễu
SKRN-IENK	diệc
SKRN-IET	diệm
SKRN-IEN	diện
SKRN-IETK	diệp
SKRN-IENT	diệt
SKRN-IEJG	diệu
SKR-O	do
SKR-U	doa
SKR-UK	doanh
SKR-OJ	doi
SKR-OT	dom
SKR-ON	don
SKR-OG	dong
SKR-HUK	doành
SKR-SU	doá
SKRN-SUJ	doãi
SKRN-SUN	doãn
SKRN-U	doạ
SKR-IU	du
SKR-UO	dua
SKR-IUN	dun
SKR-IUG	dung
SKR-UY	duy
SKR-EYN	duyên
SKRN-EYNT	duyệt
SKR-UOJ	duôi
SKR-HUEK	duềnh
SKRN-UE	duệ
SKR-SUONK	duốc
SKR-SUOJ	duối
SKRN-SUOJ	duỗi
SKRN-UONK	duộc
SKR-HA	dà
SKR-HAJ	dài
SKR-HAT	dàm
SKR-HAN	dàn
SKR-HAG	dàng
SKR-HAK	dành
SKR-HAJK	dào
SKR-HAJG	dàu
SKR-HAJN	dày
SKR-SA	dá
SKR-SANK	dác
SKR-SAGK	dách
SKR-SAJ	dái
SKR-SAT	dám
SKR-SAN	dán
SKR-SAG	dáng
SKR-SAJK	dáo
SKR-SANT	dát
SKR-SAJN	dáy
SKR*-ET	dâm
SKR*-EN	dân
SKR*-EG	dâng
SKR*-EJG	dâu
SKR*-EJN	dây
SKRN-SA	dã
SKRN-SAJ	dãi
SKRN-SAN	dãn
SKRN-SAJK	dão
SKRN-SAJN	dãy
SKR-HE	dè
SKR-HEN	dèn
SKR-SE	dé
SKR-SET	dém
SKR-SETK	dép
SKR-OE	dê
SKR-OEK	dênh
SKR-H*I	dì
SKR-HIE	dìa
SKR-H*IT	dìm
SKR-H*IJG	dìu
SKR-S*I	dí
SKR-S*IT	dím
SKR-S*IK	dính
SKR-S*ITK	díp
SKR-S*IJG	díu
SKR-HO	dò
SKR-HOJ	dòi
SKR-HOT	dòm
SKR-HOG	dòng
SKR-SO	dó
SKR-SONK	dóc
SKR-SOJ	dói
SKR-SOT	dóm
SKR-SOG	dóng
SKR-OA	dô
SKR-OAJ	dôi
SKR-OAG	dông
SKRN-SO	dõ
SKRN-SOJ	dõi
SKRN-SOT	dõm
SKRN-SOG	dõng
SKR-HIU	dù
SKR-HUO	dùa
SKR-HIUJ	dùi
SKR-HIUN	dùn
SKR-HIUG	dùng
SKR-SUO	dúa
SKR-SIUJ	dúi
SKR-SIUT	dúm
SKR-SIUN	dún
SKR-SIUG	dúng
SKR-SIUNT	dút
SKR*-AT	dăm
SKR*-AN	dăn
SKR*-AG	dăng
SKRN-S*I	dĩ
SKRN-SIE	dĩa
SKRN-S*IN	dĩn
SKRN-S*IK	dĩnh
SKRN-SUO	dũa
SKRN-SIUJ	dũi
SKRN-SIUG	dũng
SKR-OY	dơ
SKR-OYJ	dơi
SKR-OYN	dơn
SKR-UA	dư
SKR-EA	dưa
SKR-UAG	dưng
SKR-EAG	dương
SKR-SEAJ	dưới
SKR-SEAN	dướn
SKR-SEAG	dướng
SKR-HEAN	dườn
SKR-HEAG	dường
SKRN-SEAG	dưỡng
SKRN-EANK	dược
SKRN-EAJ	dượi
SKRN-EAG	dượng
SKRN-EANT	dượt
SKRN-A	dạ
SKRN-ANK	dạc
SKRN-AJ	dại
SKRN-AT	dạm
SKRN-AN	dạn
SKRN-AG	dạng
SKRN-AJK	dạo
SKRN-ANT	dạt
SKRN-AJN	dạy
SKR-HSA	dả
SKR-HSAJ	dải
SKR-HSAK	dảnh
SKR-HSAJN	dảy
SKR-S*ET	dấm
SKR-S*EN	dấn
SKR-S*ETK	dấp
SKR-S*EJG	dấu
SKR-S*EJN	dấy
SKR-H*ET	dầm
SKR-H*EN	dần
SKR-H*EJG	dầu
SKR-H*EJN	dầy
SKR-HS*ET	dẩm
SKR-HS*EN	dẩn
SKR-HS*EJG	dẩu
SKR-HS*EJN	dẩy
SKRN-S*ET	dẫm
SKRN-S*EN	dẫn
SKRN-S*EJG	dẫu
SKRN-S*EJN	dẫy
SKRN*-ET	dậm
SKRN*-EN	dận
SKRN*-ETK	dập
SKRN*-ENT	dật
SKRN*-EJG	dậu
SKRN*-EJN	dậy
SKR-S*AG	dắng
SKR-S*ANT	dắt
SKR-H*AT	dằm
SKR-H*AN	dằn
SKR-H*AG	dằng
SKR-HS*AN	dẳn
SKR-HS*AG	dẳng
SKRN*-ANK	dặc
SKRN*-AT	dặm
SKRN*-AN	dặn
SKRN*-AG	dặng
SKRN*-ANT	dặt
SKRN-ETK	dẹp
SKRN-ENT	dẹt
SKR-HSE	dẻ
SKR-HSEJK	dẻo
SKRN-SE	dẽ
SKR-SOE	dế
SKR-SOENT	dết
SKR-HOE	dề
SKR-HOET	dềm
SKR-HOEN	dền
SKR-HOEK	dềnh
SKR-HSOE	dể
SKR-HSOEK	dểnh
SKRN-SOE	dễ
SKRN-OE	dệ
SKRN-OEGK	dệch
SKRN-OEN	dện
SKRN-OENT	dệt
SKRN*-I	dị
SKRN*-IGK	dịch
SKRN*-ITK	dịp
SKRN*-INT	dịt
SKRN*-IJG	dịu
SKRN-O	dọ
SKRN-ONK	dọc
SKRN-OJ	dọi
SKRN-OT	dọm
SKRN-ON	dọn
SKRN-OG	dọng
SKRN-OTK	dọp
SKR-HSO	dỏ
SKR-HSOT	dỏm
SKR-HSOG	dỏng
SKR-SOANK	dốc
SKR-SOAJ	dối
SKR-SOANT	dốt
SKR-HOA	dồ
SKR-HOAJ	dồi
SKR-HOAN	dồn
SKR-HOAG	dồng
SKR-HSOAJ	dổi
SKR-HSOAT	dổm
SKRN-SOA	dỗ
SKRN-SOAJ	dỗi
SKRN-OANK	dộc
SKRN-OAJ	dội
SKRN-OAG	dộng
SKRN-OATK	dộp
SKRN-OANT	dột
SKR-SOY	dớ
SKR-SOYN	dớn
SKR-SOYTK	dớp
SKR-HOY	dờ
SKR-HOYJ	dời
SKR-HOYN	dờn
SKR-HSOY	dở
SKR-HSOYT	dởm
SKRN-SOY	dỡ
SKRN-OY	dợ
SKRN-OYT	dợm
SKRN-OYN	dợn
SKRN-IU	dụ
SKRN-IUNK	dục
SKRN-IUJ	dụi
SKRN-IUT	dụm
SKRN-IUG	dụng
SKRN-IUNT	dụt
SKR-HSIUJ	dủi
SKR-SUA	dứ
SKR-SEA	dứa
SKR-SUANK	dức
SKR-SUAG	dứng
SKR-SUANT	dứt
SKR-HUA	dừ
SKR-HEA	dừa
SKR-HUAG	dừng
SKR-HSUA	dử
SKR-HSUAG	dửng
SKRN-SUA	dữ
SKRN-UA	dự
SKRN-EA	dựa
SKRN-UANK	dực
SKRN-UAG	dựng
-E	e
-ET	em
-EN	en
-EG	eng
-EJK	eo
TKR-A	ga
TKR-AJ	gai
TKR-AT	gam
TKR-AN	gan
TKR-AG	gang
TKR-AK	ganh
TKR-AJK	gao
TKR-AJG	gau
TKR-AJN	gay
TKR-E	ghe
TKR-EN	ghen
TKR*-I	ghi
TKR*-IT	ghim
TKR-SIENK	ghiếc
TKR-HIEN	ghiền
TKR-HE	ghè
TKR-HEN	ghèn
TKR-SE	ghé
TKR-SET	ghém
TKR-SETK	ghép
TKR-SENT	ghét
TKR-OE	ghê
TKR-H*I	ghì
TKR-H*IT	ghìm
TKR-S*IK	ghính
TKRN-E	ghẹ
TKRN-EJK	ghẹo
TKR-HSE	ghẻ
TKRN-SE	ghẽ
TKR-SOE	ghế
TKR-SOEGK	ghếch
TKR-HOE	ghề
TKR-HOEK	ghềnh
TKR-HSOEK	ghểnh
TKRN-OEGK	ghệch
TKRN-OENT	ghệt
TKRN*-INT	ghịt
SH*-I	gi
SH-A	gia
SH-AJ	giai
SH-AT	giam
SH-AN	gian
SH-AG	giang
SH-AK	gianh
SH-AJK	giao
SH-E	gie
SH-EN	gien
SH-EJK	gieo
SH*-IN	gin
SH-O	gio
SH-OJ	gioi
SH-ON	gion
SH-OG	giong
SH-IUN	giun
SH-SUYTK	giuýp
SHN-UONK	giuộc
SH-HA	già
SH-HAN	giàn
SH-HAG	giàng
SH-HAK	giành
SH-HAJG	giàu
SH-HAJN	giày
SH-SA	giá
SH-SANK	giác
SH-SAT	giám
SH-SAN	gián
SH-SAG	giáng
SH-SAJK	giáo
SH-SATK	giáp
SH-SANT	giát
SH*-ET	giâm
SH*-EJG	giâu
SH*-EJN	giây
SHN-SA	giã
SHN-SAJ	giãi
SHN-SAN	giãn
SHN-SAJK	gião
SHN-SAJN	giãy
SH-HET	gièm
SH-SE	gié
SH-SEJK	giéo
SH-OE	giê
SH-IEG	giêng
SH-HO	giò
SH-HOJ	giòi
SH-HOT	giòm
SH-HON	giòn
SH-SO	gió
SH-SONK	gióc
SH-SOJ	giói
SH-SOT	gióm
SH-SOG	gióng
SH-SONT	giót
SH-OA	giô
SH-OAN	giôn
SH-OAG	giông
SH-HIUJ	giùi
SH-HIUT	giùm
SH-SIU	giú
SH-SIUJ	giúi
SH-SIUTK	giúp
SH*-AT	giăm
SH*-AG	giăng
SHN-SIU	giũ
SHN-SUO	giũa
SH-OY	giơ
SH-EAG	giương
SH-SEAG	giướng
SH-HEAG	giường
SHN-A	giạ
SHN-AJ	giại
SHN-AT	giạm
SHN-AG	giạng
SHN-ATK	giạp
SHN-ANT	giạt
SH-HSA	giả
SH-HSAJ	giải
SH-HSAT	giảm
SH-HSAN	giản
SH-HSAG	giảng
SH-HSAK	giảnh
SH-HSAJK	giảo
SH-HSAJG	giảu
SH-S*ENK	giấc
SH-S*ET	giấm
SH-S*EN	giấn
SH-S*ETK	giấp
SH-S*EJG	giấu
SH-S*EJN	giấy
SH-H*ET	giầm
SH-H*EN	giần
SH-H*EJG	giầu
SH-H*EJN	giầy
SH-HS*ET	giẩm
SHN-S*ET	giẫm
SHN-S*EJN	giẫy
SHN*-ET	giậm
SHN*-EN	giận
SHN*-ETK	giập
SHN*-ENT	giật
SHN*-EJG	giậu
SH-S*ANT	giắt
SH-H*AT	giằm
SH-H*AN	giằn
SH-H*AG	giằng
SHN-S*AT	giẵm
SHN*-ANK	giặc
SHN*-AT	giặm
SHN*-AN	giặn
SHN*-ANT	giặt
SHN-EJK	giẹo
SHN-ETK	giẹp
SH-HSE	giẻ
SHN-SE	giẽ
SH-SIENK	giếc
SH-SIET	giếm
SH-SIEG	giếng
SH-SIENT	giết
SH-HOEN	giền
SH-HIEG	giềng
SHN-SIEJG	giễu
SHN-O	giọ
SHN-OJ	giọi
SHN-OT	giọm
SHN-OG	giọng
SHN-ONT	giọt
SH-HSO	giỏ
SH-HSOJ	giỏi
SH-HSOT	giỏm
SH-HSON	giỏn
SH-HSOG	giỏng
SH-SOAG	giống
SH-SOANT	giốt
SH-HOA	giồ
SH-HOAJ	giồi
SH-HOAG	giồng
SH-HSOAJ	giổi
SHN-SOA	giỗ
SHN-SOAJ	giỗi
SHN-OAJ	giội
SHN-OATK	giộp
SH-SOYJ	giới
SH-HOY	giờ
SH-HOYJ	giời
SH-HOYN	giờn
SH-HSOY	giở
SHN-SOYN	giỡn
SHN-UO	giụa
SHN-IUNK	giục
SHN-IUJ	giụi
SH-HSIUJ	giủi
SHN-SUA	giữ
SHN-SEA	giữa
SHN-UANT	giựt
TKR-O	go
TKR-OT	gom
TKR-ON	gon
TKR-SU	goá
TKR-IU	gu
TKR-SUONK	guốc
TKR-HUOG	guồng
TKRN-UONK	guộc
TKRN-UON	guộn
TKRN-UONT	guột
TKR-HA	gà
TKR-HAJ	gài
TKR-HAN	gàn
TKR-HAG	gàng
TKR-HAK	gành
TKR-HAJK	gào
TKR-HAJG	gàu
TKR-HAJN	gày
TKR-SA	gá
TKR-SANK	gác
TKR-SAJ	gái
TKR-SAN	gán
TKR-SAK	gánh
TKR-SAJK	gáo
TKR-SATK	gáp
TKR-SAJG	gáu
TKR-SAJN	gáy
TKR*-EN	gân
TKR*-EJG	gâu
TKR*-EJN	gây
TKRN-SA	gã
TKRN-SAJ	gãi
TKRN-SAJN	gãy
SH-H*I	gì
SH-H*IN	gìn
SH-S*I	gí
SH-S*IGK	gích
SH-S*ITK	gíp
TKR-HO	gò
TKR-HON	gòn
TKR-SONK	góc
TKR-SOJ	gói
TKR-SOTK	góp
TKR-SONT	gót
TKR-OA	gô
TKR-OAT	gôm
TKR-OAN	gôn
TKR-OAG	gông
TKRN-SO	gõ
TKR-HIU	gù
TKR-HUO	gùa
TKR-HIUJ	gùi
TKR-HIUN	gùn
TKR-HIUG	gùng
TKR-SIUNT	gút
TKR*-AT	găm
TKR*-AG	găng
TKRN-SIUJ	gũi
TKR-OY	gơ
TKR-EAT	gươm
TKR-EAG	gương
TKR-HEAT	gườm
TKRN-SEAG	gưỡng
TKRN-EAT	gượm
TKRN-EAG	gượng
TKRN-A	gạ
TKRN-ANK	gạc
TKRN-AGK	gạch
TKRN-AJ	gại
TKRN-AN	gạn
TKRN-AK	gạnh
TKRN-AJK	gạo
TKRN-ANT	gạt
TKRN-AJN	gạy
TKR-HSA	gả
TKR-HSAK	gảnh
TKR-HSAJN	gảy
TKR-S*ENK	gấc
TKR-S*ET	gấm
TKR-S*ETK	gấp
TKR-S*EJG	gấu
TKR-S*EJN	gấy
TKR-H*ET	gầm
TKR-H*EN	gần
TKR-H*EJG	gầu
TKR-H*EJN	gầy
TKR-HS*ET	gẩm
TKR-HS*EJN	gẩy
TKRN-S*ET	gẫm
TKRN-S*EJG	gẫu
TKRN-S*EJN	gẫy
TKRN*-ET	gậm
TKRN*-ETK	gập
TKRN*-ENT	gật
TKRN*-EJN	gậy
TKR-S*AT	gắm
TKR-S*AN	gắn
TKR-S*AG	gắng
TKR-S*ATK	gắp
TKR-S*ANT	gắt
TKR-H*AT	gằm
TKR-H*AN	gằn
TKRN-S*AG	gẵng
TKRN*-ANK	gặc
TKRN*-AT	gặm
TKRN*-AN	gặn
TKRN*-AG	gặng
TKRN*-ATK	gặp
TKRN*-ANT	gặt
SH-HS*I	gỉ
TKRN-O	gọ
TKRN-OJ	gọi
TKRN-OT	gọm
TKRN-ON	gọn
TKRN-OG	gọng
TKRN-ONT	gọt
TKR-HSOJ	gỏi
TKR-HSOT	gỏm
TKR-HSOG	gỏng
TKR-SOANK	gốc
TKR-SOAJ	gối
TKR-SOAT	gốm
TKR-HOA	gồ
TKR-HOAJ	gồi
TKR-HOAT	gồm
TKR-HOAG	gồng
TKR-HSOA	gổ
TKR-HSOAT	gổm
TKRN-SOA	gỗ
TKRN-OA	gộ
TKRN-OANK	gộc
TKRN-OAJ	gội
TKRN-OATK	gộp
TKRN-OANT	gột
TKR-SOYT	gớm
TKR-HOY	gờ
TKR-HOYT	gờm
TKR-HOYN	gờn
TKR-HSOY	gở
TKR-HSOYJ	gởi
TKRN-SOY	gỡ
TKRN-OYJ	gợi
TKRN-OYN	gợn
TKRN-OYNT	gợt
TKRN-IU	gụ
TKRN-IUNK	gục
TKRN-IUJ	gụi
TKR-HUA	gừ
TKR-HUAG	gừng
TKR-HSUAJ	gửi
H-A	ha
H-AJ	hai
H-AT	ham
H-AN	han
H-AG	hang
H-AK	hanh
H-AJK	hao
H-AJG	hau
H-AJN	hay
H-E	he
H-ET	hem
H-EN	hen
H-EJK	heo
H*-I	hi
H-IE	hia
H*-IT	him
H*-IN	hin
H*-IJG	hiu
H-IEN	hiên
H-IEG	hiêng
H-SIET	hiếm
H-SIEN	hiến
H-SIEG	hiếng
H-SIETK	hiếp
H-SIEJG	hiếu
H-HIET	hiềm
H-HIEN	hiền
H-HSIET	hiểm
H-HSIEN	hiển
H-HSIEJG	hiểu
HN-IEN	hiện
HN-IETK	hiệp
HN-IENT	hiệt
HN-IEJG	hiệu
H-O	ho
H-U	hoa
H-UJ	hoai
H-UN	hoan
H-UG	hoang
H-UJN	hoay
H-AY	hoe
H-AYN	hoen
H-OJ	hoi
H-OT	hom
H-ON	hon
H-OG	hong
H-HU	hoà
H-HUJ	hoài
H-HUN	hoàn
H-HUG	hoàng
H-HUK	hoành
H-SU	hoá
H-SUNK	hoác
H-SUN	hoán
H-SUG	hoáng
H-SUK	hoánh
H-SUJN	hoáy
HN-SUN	hoãn
HN-SUG	hoãng
H-HAY	hoè
H-SAYNT	hoét
H*-UG	hoăng
HN-U	hoạ
HN-UGK	hoạch
HN-UJ	hoại
HN-UN	hoạn
HN-UK	hoạnh
HN-UNT	hoạt
H-HSU	hoả
H-HSUJ	hoải
H-HSUG	hoảng
H-HSUK	hoảnh
H-S*UNK	hoắc
H-S*UT	hoắm
H-S*UNT	hoắt
H-H*UN	hoằn
H-HS*UN	hoẳn
HN-S*UG	hoẵng
HN*-UNK	hoặc
HN-AY	hoẹ
H-HSAYN	hoẻn
H-IU	hu
H-UO	hua
H-IUJ	hui
H-IUT	hum
H-IUN	hun
H-IUG	hung
H-UY	huy
H-UYK	huynh
H-EYN	huyên
H-SEYNT	huyết
H-HEYN	huyền
HN-SEYN	huyễn
HN-EYN	huyện
HN-EYNT	huyệt
H*-YN	huân
H-UE	huê
H-UEK	huênh
H-SUY	huý
H-SUYGK	huých
H-SUYNT	huýt
H-Y	huơ
H-S*YN	huấn
H-SUE	huế
H-SUEGK	huếch
H-HUE	huề
HN-UE	huệ
H-SUOG	huống
H-SUONT	huốt
H-HSUOJ	huổi
H-HUYK	huỳnh
HN-UYGK	huỵch
H-HSUY	huỷ
H-I	hy
H-HA	hà
H-HAJ	hài
H-HAT	hàm
H-HAN	hàn
H-HAG	hàng
H-HAK	hành
H-HAJK	hào
H-HAJG	hàu
H-SA	há
H-SANK	hác
H-SAGK	hách
H-SAJ	hái
H-SAT	hám
H-SAN	hán
H-SAG	háng
H-SAK	hánh
H-SAJK	háo
H-SATK	háp
H-SANT	hát
H-SAJG	háu
H-SAJN	háy
H*-ET	hâm
H*-EN	hân
H*-EJG	hâu
H*-EJN	hây
HN-SAJ	hãi
HN-SAT	hãm
HN-SAN	hãn
HN-SAG	hãng
HN-SAK	hãnh
HN-SAJK	hão
HN-SAJN	hãy
H-HE	hè
H-HET	hèm
H-HEN	hèn
H-HEJK	hèo
H-SE	hé
H-SENK	héc
H-SEN	hén
H-SEJK	héo
H-SENT	hét
H-OE	hê
H-OEN	hên
H-OEK	hênh
H-H*I	hì
H-H*IK	hình
H-S*I	hí
H-S*IGK	hích
H-S*ITK	híp
H-S*INT	hít
H-HO	hò
H-HOJ	hòi
H-HOT	hòm
H-HON	hòn
H-HOG	hòng
H-SO	hó
H-SONK	hóc
H-SOJ	hói
H-SOT	hóm
H-SOG	hóng
H-SOTK	hóp
H-SONT	hót
H-OA	hô
H-OAJ	hôi
H-OAT	hôm
H-OAN	hôn
H-OAG	hông
HN-SO	hõ
HN-SOT	hõm
H-HIU	hù
H-HUO	hùa
H-HIUJ	hùi
H-HIUT	hùm
H-HIUN	hùn
H-HIUG	hùng
H-SIU	hú
H-SIUNK	húc
H-SIUJ	húi
H-SIUG	húng
H-SIUTK	húp
H-SIUNT	hút
H-SI	hý
H*-AT	hăm
H*-AG	hăng
HN-S*I	hĩ
HN-S*IT	hĩm
HN-S*IK	hĩnh
HN-SIU	hũ
HN-SIUT	hũm
H-OY	hơ
H-OYJ	hơi
H-OYN	hơn
H-UA	hư
H-UAG	hưng
H-EAT	hươm
H-EAN	hươn
H-EAG	hương
H-EAJG	hươu
H-SEANK	hước
H-SEAG	hướng
H-HEAT	hườm
H-HEAG	hường
H-HSEAG	hưởng
HN-EAT	hượm
HN-A	hạ
HN-ANK	hạc
HN-AGK	hạch
HN-AJ	hại
HN-AT	hạm
HN-AN	hạn
HN-AG	hạng
HN-AK	hạnh
HN-AJK	hạo
HN-ATK	hạp
HN-ANT	hạt
H-HSA	hả
H-HSAJ	hải
H-HSAG	hảng
H-HSAK	hảnh
H-HSAJK	hảo
H-S*ET	hấm
H-S*EN	hấn
H-S*ETK	hấp
H-S*ENT	hất
H-S*EJG	hấu
H-S*EJN	hấy
H-H*ET	hầm
H-H*EJG	hầu
H-H*EJN	hầy
H-HS*ET	hẩm
H-HS*EG	hẩng
H-HS*EJG	hẩu
H-HS*EJN	hẩy
HN-S*EG	hẫng
HN-S*EJG	hẫu
HN*-ET	hậm
HN*-EN	hận
HN*-ETK	hập
HN*-EJG	hậu
H-S*ANK	hắc
H-S*AN	hắn
H-S*AG	hắng
H-S*ANT	hắt
H-H*AT	hằm
H-H*AN	hằn
H-H*AG	hằng
H-HS*AT	hẳm
H-HS*AN	hẳn
HN-S*AG	hẵng
HN*-ANK	hặc
HN*-AT	hặm
HN-E	hẹ
HN-EN	hẹn
HN-ETK	hẹp
H-HSET	hẻm
H-HSEN	hẻn
H-HSEJK	hẻo
HN-SET	hẽm
H-SOEGK	hếch
H-SOEN	hến
H-SOENT	hết
H-SOEJG	hếu
H-HOE	hề
H-HOEK	hềnh
H-HSOE	hể
H-HSOEN	hển
H-HSOEK	hểnh
HN-SOE	hễ
HN-OE	hệ
HN-OEGK	hệch
HN-OENT	hệt
H-HS*I	hỉ
H-HS*IK	hỉnh
HN*-IGK	hịch
HN-O	họ
HN-ONK	học
HN-OG	họng
HN-OTK	họp
H-HSO	hỏ
H-HSOJ	hỏi
H-HSOT	hỏm
H-HSON	hỏn
H-HSOG	hỏng
H-SOA	hố
H-SOANK	hốc
H-SOAJ	hối
H-SOAG	hống
H-SOANT	hốt
H-HOA	hồ
H-HOAJ	hồi
H-HOAN	hồn
H-HOAG	hồng
H-HSOA	hổ
H-HSOAJ	hổi
H-HSOAT	hổm
H-HSOAN	hổn
H-HSOAG	hổng
HN-SOA	hỗ
HN-SOAN	hỗn
HN-SOAG	hỗng
HN-OA	hộ
HN-OANK	hộc
HN-OAJ	hội
HN-OAN	hộn
HN-OATK	hộp
HN-OANT	hột
H-SOY	hớ
H-SOYJ	hới
H-SOYT	hớm
H-SOYN	hớn
H-SOYTK	hớp
H-SOYNT	hớt
H-HOY	hờ
H-HOYJ	hời
H-HOYT	hờm
H-HOYN	hờn
H-HSOY	hở
H-HSOYJ	hởi
H-HSOYN	hởn
HN-SOY	hỡ
HN-SOYJ	hỡi
HN-OYJ	hợi
HN-OYT	hợm
HN-OYTK	hợp
HN-OYNT	hợt
HN-IU	hụ
HN-IUNK	hục
HN-IUJ	hụi
HN-IUT	hụm
HN-IUTK	hụp
HN-IUNT	hụt
H-HSIU	hủ
H-HSIUJ	hủi
H-HSIUN	hủn
H-SUA	hứ
H-SEA	hứa
H-SUANK	hức
H-SUAG	hứng
H-HUA	hừ
H-HUAG	hừng
H-HSUA	hử
H-HSUAG	hửng
HN-SUA	hữ
HN-SUAG	hững
HN-SUAJG	hữu
HN-UA	hự
HN-UANK	hực
H-HSI	hỷ
*-I	i
*-IT	im
*-IN	in
*-IK	inh
*-IJG	iu
K-E	ke
K-ET	kem
K-EN	ken
K-EG	keng
K-EJK	keo
KH-A	kha
KH-AJ	khai
KH-AT	kham
KH-AN	khan
KH-AG	khang
KH-AK	khanh
KH-AJK	khao
KH-AJG	khau
KH-AJN	khay
KH-E	khe
KH-ET	khem
KH-EN	khen
KH-EJK	kheo
KH*-I	khi
KH*-IN	khin
KH*-IK	khinh
KH*-IJG	khiu
KH-IET	khiêm
KH-IEN	khiên
KH-IEG	khiêng
KH-IEJG	khiêu
KH-SIET	khiếm
KH-SIEN	khiến
KH-SIETK	khiếp
KH-SIENT	khiết
KH-SIEJG	khiếu
KH-HIEN	khiền
KH-HSIEN	khiển
KHN-SIEG	khiễng
KHN-IEG	khiệng
KH-O	kho
KH-U	khoa
KH-UJ	khoai
KH-UN	khoan
KH-UG	khoang
KH-UK	khoanh
KH-AY	khoe
KH-AYN	khoen
KH-AYJK	khoeo
KH-OJ	khoi
KH-OT	khom
KH-SU	khoá
KH-SUNK	khoác
KH-SUJ	khoái
KH-SUN	khoán
KH-SUG	khoáng
KH-SUNT	khoát
KH-SUJN	khoáy
KH-HAYJK	khoèo
KH-SAY	khoé
KH-SAYNT	khoét
KH*-UN	khoăn
KH-HSU	khoả
KH-HSUJ	khoải
KH-HSUN	khoản
KH-HSUG	khoảng
KH-HSUK	khoảnh
KH-S*UN	khoắn
KH-S*UG	khoắng
KH-S*UNT	khoắt
KH-H*UT	khoằm
KHN*-UT	khoặm
KHN*-UTK	khoặp
KH-HSAY	khoẻ
KH-HSAYJK	khoẻo
KH-IU	khu
KH-UO	khua
KH-IUJ	khui
KH-IUT	khum
KH-IUG	khung
KH-UY	khuy
KH-EY	khuya
KH-UYK	khuynh
KH-EYN	khuyên
KH-SEYN	khuyến
KH-SEYNT	khuyết
KH-HSEYN	khuyển
KH*-YN	khuân
KH*-YG	khuâng
KH*-YJN	khuây
KH-UE	khuê
KH-UON	khuôn
KH-UOG	khuông
KH-SUYTK	khuýp
KH-Y	khuơ
KH-S*YNT	khuất
KH-S*YJN	khuấy
KH-HS*YN	khuẩn
KH-SUEGK	khuếch
KHN-UEK	khuệnh
KH-HUYK	khuỳnh
KHN-UY	khuỵ
KHN-UYJG	khuỵu
KH-HSUYK	khuỷnh
KH-HSUYJG	khuỷu
KH-HA	khà
KH-HAN	khàn
KH-HAG	khàng
KH-SA	khá
KH-SANK	khác
KH-SAGK	khách
KH-SAJ	khái
KH-SAT	khám
KH-SAN	khán
KH-SAG	kháng
KH-SAK	khánh
KH-SAJK	kháo
KH-SATK	kháp
KH-SANT	khát
KH-SAJG	kháu
KH-SAJN	kháy
KH*-ET	khâm
KH*-EN	khân
KH*-EJG	khâu
KH-HE	khè
KH-HEN	khèn
KH-SE	khé
KH-SEN	khén
KH-SEJK	khéo
KH-SETK	khép
KH-SENT	khét
KH-OE	khê
KH-OEK	khênh
KH-OEJG	khêu
KH-H*I	khì
KH-H*IN	khìn
KH-S*I	khí
KH-SIE	khía
KH-S*IGK	khích
KH-S*INT	khít
KH-S*IJG	khíu
KH-HO	khò
KH-HOT	khòm
KH-HOG	khòng
KH-SO	khó
KH-SONK	khóc
KH-SOJ	khói
KH-SOT	khóm
KH-OA	khô
KH-OAJ	khôi
KH-OAN	khôn
KH-OAG	không
KHN-SOT	khõm
KH-HIU	khù
KH-HIUG	khùng
KH-SIU	khú
KH-SIUNK	khúc
KH-SIUT	khúm
KH-SIUG	khúng
KH*-AT	khăm
KH*-AN	khăn
KH*-AG	khăng
KH-OY	khơ
KH-OYJ	khơi
KH-UA	khư
KH-EAJ	khươi
KH-EAN	khươn
KH-EAG	khương
KH-SEANK	khước
KH-SEANT	khướt
KH-SEAJG	khướu
KH-HSEAG	khưởng
KHN-SEAG	khưỡng
KHN-EANT	khượt
KHN-ANK	khạc
KHN-AG	khạng
KHN-AJK	khạo
KHN-ATK	khạp
KH-HSA	khả
KH-HSAJ	khải
KH-HSAT	khảm
KH-HSAN	khản
KH-HSAG	khảng
KH-HSAK	khảnh
KH-HSAJK	khảo
KH-HSAJN	khảy
KH-S*ENK	khấc
KH-S*ET	khấm
KH-S*EN	khấn
KH-S*ETK	khấp
KH-S*ENT	khất
KH-S*EJG	khấu
KH-HS*EN	khẩn
KH-HS*EJG	khẩu
KH-HS*EJN	khẩy
KHN*-ETK	khập
KHN*-ENT	khật
KH-S*ANK	khắc
KH-S*AT	khắm
KH-S*AN	khắn
KH-S*AG	khắng
KH-S*ATK	khắp
KH-S*ANT	khắt
KH-H*AN	khằn
KH-H*AG	khằng
KH-HS*AT	khẳm
KH-HS*AN	khẳn
KH-HS*AG	khẳng
KHN*-ANK	khặc
KHN-ENK	khẹc
KH-HSE	khẻ
KHN-SE	khẽ
KH-SOE	khế
KH-HOE	khề
KH-HOEK	khềnh
KH-HOEJG	khều
KH-HSOEK	khểnh
KHN-SOEK	khễnh
KHN-OE	khệ
KHN-OEK	khệnh
KH-HS*I	khỉ
KH-HS*IK	khỉnh
KHN-IE	khịa
KHN*-INT	khịt
KHN-OT	khọm
KH-HSO	khỏ
KH-HSOJ	khỏi
KH-HSOT	khỏm
KH-HSOG	khỏng
KH-SOA	khố
KH-SOANK	khốc
KH-SOAJ	khối
KH-SOAN	khốn
KH-SOAG	khống
KH-HSOA	khổ
KH-HSOAG	khổng
KH-SOY	khớ
KH-SOYJ	khới
KH-SOYTK	khớp
KH-HOY	khờ
KH-HSOYJ	khởi
KHN-IU	khụ
KHN-IUNK	khục
KHN-IUG	khụng
KHN-IUNT	khụt
KH-HSIU	khủ
KH-HSUO	khủa
KH-HSIUG	khủng
KH-SUA	khứ
KH-SEA	khứa
KH-SUAG	khứng
KH-SUAJG	khứu
KH-HUA	khừ
KH-HUAG	khừng
KH-HSUA	khử
KHN-UAG	khựng
K*-I	ki
K-IE	kia
K*-IT	kim
K*-IK	kinh
K-IET	kiêm
K-IEN	kiên
K-IEG	kiêng
K-IEJG	kiêu
K-SIET	kiếm
K-SIEN	kiến
K-SIEG	kiếng
K-SIETK	kiếp
K-SIENT	kiết
K-SIEJG	kiếu
K-HIET	kiềm
K-HIEN	kiền
K-HIEG	kiềng
K-HIEJG	kiều
K-HSIET	kiểm
K-HSIEG	kiểng
K-HSIEJG	kiểu
KN-SIEG	kiễng
KN-IET	kiệm
KN-IEN	kiện
KN-IENT	kiệt
KN-IEJG	kiệu
K-HE	kè
K-HET	kèm
K-HEN	kèn
K-HEJK	kèo
K-SE	ké
K-SENK	kéc
K-SET	kém
K-SEN	kén
K-SEJK	kéo
K-SETK	kép
K-SENT	két
K-OE	kê
K-OEN	kên
K-OEK	kênh
K-OEJG	kêu
K-H*I	kì
K-HIE	kìa
K-H*IT	kìm
K-H*IN	kìn
K-H*IK	kình
K-S*I	kí
K-S*IGK	kích
K-S*IN	kín
K-S*IK	kính
K-S*ITK	kíp
K-S*INT	kít
K-SI	ký
KN-S*I	kĩ
KN-S*IJG	kĩu
KN-E	kẹ
KN-ENK	kẹc
KN-EN	kẹn
KN-EJK	kẹo
KN-ETK	kẹp
KN-ENT	kẹt
K-HSE	kẻ
K-HSEG	kẻng
K-HSEJK	kẻo
KN-SE	kẽ
KN-SET	kẽm
KN-SEJK	kẽo
K-SOE	kế
K-SOEGK	kếch
K-SOETK	kếp
K-SOENT	kết
K-SOEJG	kếu
K-HOE	kề
K-HOET	kềm
K-HOEN	kền
K-HOEK	kềnh
K-HOEJG	kều
K-HSOE	kể
KN-SOEK	kễnh
KN-OE	kệ
KN-OEGK	kệch
KN-OEK	kệnh
K-HS*I	kỉ
K-HS*IK	kỉnh
KN*-I	kị
KN*-IGK	kịch
KN*-ITK	kịp
KN*-INT	kịt
K-HI	kỳ
KN-I	kỵ
K-HSI	kỷ
KN-SI	kỹ
SR-A	la
SR-AJ	lai
SR-AT	lam
SR-AN	lan
SR-AG	lang
SR-AK	lanh
SR-AJK	lao
SR-AJG	lau
SR-AJN	lay
SR-E	le
SR-ET	lem
SR-EN	len
SR-EG	leng
SR-EJK	leo
SR*-I	li
SR-IE	lia
SR*-IT	lim
SR*-IN	lin
SR*-IK	linh
SR*-IJG	liu
SR-IET	liêm
SR-IEN	liên
SR-IEG	liêng
SR-IEJG	liêu
SR-SIENK	liếc
SR-SIET	liếm
SR-SIEN	liến
SR-SIEG	liếng
SR-SIETK	liếp
SR-HIET	liềm
SR-HIEN	liền
SR-HIEJG	liều
SR-HSIEG	liểng
SRN-SIET	liễm
SRN-SIEN	liễn
SRN-SIEJG	liễu
SRN-IET	liệm
SRN-IEG	liệng
SRN-IETK	liệp
SRN-IENT	liệt
SRN-IEJG	liệu
SR-O	lo
SR-U	loa
SR-UN	loan
SR-UG	loang
SR-UK	loanh
SR-UJN	loay
SR-AY	loe
SR-AYN	loen
SR-OJ	loi
SR-OT	lom
SR-ON	lon
SR-OG	long
SR*-OG	loong
SR-HU	loà
SR-HUJ	loài
SR-HUN	loàn
SR-HUG	loàng
SR-SU	loá
SR-SUG	loáng
SR-SUNT	loát
SRN-SU	loã
SRN-SUG	loãng
SR-HAY	loè
SR-SAY	loé
SR-SAYNT	loét
SR*-UN	loăn
SR*-UG	loăng
SRN-UNK	loạc
SRN-UJ	loại
SRN-UN	loạn
SRN-UG	loạng
SRN-UNT	loạt
SR-HSU	loả
SR-HSUG	loảng
SR-S*UNT	loắt
SR-H*UG	loằng
SRN-AYNT	loẹt
SR-IU	lu
SR-UO	lua
SR-IUJ	lui
SR-IUT	lum
SR-IUG	lung
SR-EY	luya
SR-UYN	luyn
SR-SEYN	luyến
SRN-EYN	luyện
SR*-YN	luân
SR-UOT	luôm
SR-UON	luôn
SR-UOG	luông
SR-SUY	luý
SR-SUYGK	luých
SR-S*YN	luấn
SR-HS*YN	luẩn
SRN*-YN	luận
SRN*-YNT	luật
SR-SUENT	luết
SRN-UENT	luệt
SR-SUONK	luốc
SR-SUOG	luống
SR-SUONT	luốt
SR-HUON	luồn
SR-HUOG	luồng
SRN-SUOG	luỗng
SRN-UONK	luộc
SRN-UOT	luộm
SRN-UY	luỵ
SRN-SUY	luỹ
SR-I	ly
SR-HA	là
SR-HAJ	lài
SR-HAT	làm
SR-HAN	làn
SR-HAG	làng
SR-HAK	lành
SR-HAJK	lào
SR-HAJG	làu
SR-SA	lá
SR-SANK	lác
SR-SAGK	lách
SR-SAJ	lái
SR-SAN	lán
SR-SAG	láng
SR-SAK	lánh
SR-SAJK	láo
SR-SATK	láp
SR-SANT	lát
SR-SAJG	láu
SR-SAJN	láy
SR*-ET	lâm
SR*-EN	lân
SR*-EG	lâng
SR*-EJG	lâu
SR*-EJN	lây
SRN-SA	lã
SRN-SAJ	lãi
SRN-SAT	lãm
SRN-SAN	lãn
SRN-SAG	lãng
SRN-SAK	lãnh
SRN-SAJK	lão
SR-HE	lè
SR-HET	lèm
SR-HEN	lèn
SR-HEG	lèng
SR-HEJK	lèo
SR-SE	lé
SR-SENK	léc
SR-SET	lém
SR-SEN	lén
SR-SEG	léng
SR-SEJK	léo
SR-SETK	lép
SR-SENT	lét
SR-OE	lê
SR-OEN	lên
SR-OEK	lênh
SR-OEJG	lêu
SR-H*I	lì
SR-HIE	lìa
SR-H*IT	lìm
SR-H*IK	lình
SR-H*IJG	lìu
SR-S*I	lí
SR-S*IGK	lích
SR-S*IK	lính
SR-S*ITK	líp
SR-S*INT	lít
SR-S*IJG	líu
SR-HO	lò
SR-HOJ	lòi
SR-HOT	lòm
SR-HON	lòn
SR-HOG	lòng
SR-SO	ló
SR-SONK	lóc
SR-SOJ	lói
SR-SOT	lóm
SR-SOG	lóng
SR-SOTK	lóp
SR-SONT	lót
SR-OA	lô
SR-OAJ	lôi
SR-OAT	lôm
SR-OAG	lông
SRN-SO	lõ
SRN-SOJ	lõi
SRN-SOT	lõm
SRN-SOG	lõng
SR-HIU	lù
SR-HUO	lùa
SR-HIUJ	lùi
SR-HIUT	lùm
SR-HIUN	lùn
SR-HIUG	lùng
SR-SIU	lú
SR-SUO	lúa
SR-SIUNK	lúc
SR-SIUJ	lúi
SR-SIUT	lúm
SR-SIUN	lún
SR-SIUG	lúng
SR-SIUTK	lúp
SR-SIUNT	lút
SR-SI	lý
SR*-AT	lăm
SR*-AN	lăn
SR*-AG	lăng
SRN-S*I	lĩ
SRN-S*IK	lĩnh
SRN-SIU	lũ
SRN-SUO	lũa
SRN-SIUJ	lũi
SRN-SIUT	lũm
SRN-SIUN	lũn
SRN-SIUG	lũng
SR-OY	lơ
SR-OYJ	lơi
SR-OYN	lơn
SR-UA	lư
SR-EA	lưa
SR-UAG	lưng
SR-UAJG	lưu
SR-EAT	lươm
SR-EAN	lươn
SR-EAG	lương
SR-SEAJ	lưới
SR-SEAG	lướng
SR-SEANT	lướt
SR-HEAJ	lười
SR-HEAT	lườm
SR-HEAN	lườn
SR-HEAG	lường
SRN-SEAJ	lưỡi
SRN-SEAG	lưỡng
SRN-EANK	lược
SRN-EAT	lượm
SRN-EAN	lượn
SRN-EAG	lượng
SRN-EANT	lượt
SRN-A	lạ
SRN-ANK	lạc
SRN-AGK	lạch
SRN-AJ	lại
SRN-AT	lạm
SRN-AN	lạn
SRN-AG	lạng
SRN-AK	lạnh
SRN-AJK	lạo
SRN-ATK	lạp
SRN-ANT	lạt
SRN-AJG	lạu
SRN-AJN	lạy
SR-HSA	lả
SR-HSAJ	lải
SR-HSAT	lảm
SR-HSAN	lản
SR-HSAG	lảng
SR-HSAK	lảnh
SR-HSAJK	lảo
SR-HSAJG	lảu
SR-HSAJN	lảy
SR-S*ENK	lấc
SR-S*ET	lấm
SR-S*EN	lấn
SR-S*ETK	lấp
SR-S*ENT	lất
SR-S*EJN	lấy
SR-H*ET	lầm
SR-H*EN	lần
SR-H*EJG	lầu
SR-H*EJN	lầy
SR-HS*ET	lẩm
SR-HS*EN	lẩn
SR-HS*EJG	lẩu
SR-HS*EJN	lẩy
SRN-S*ET	lẫm
SRN-S*EN	lẫn
SRN-S*EJN	lẫy
SRN*-EN	lận
SRN*-ETK	lập
SRN*-ENT	lật
SRN*-EJG	lậu
SRN*-EJN	lậy
SR-S*ANK	lắc
SR-S*AT	lắm
SR-S*AG	lắng
SR-S*ATK	lắp
SR-S*ANT	lắt
SR-H*AT	lằm
SR-H*AN	lằn
SR-H*AG	lằng
SR-HS*AT	lẳm
SR-HS*AN	lẳn
SR-HS*AG	lẳng
SRN-S*AG	lẵng
SRN*-ANK	lặc
SRN*-AT	lặm
SRN*-AN	lặn
SRN*-AG	lặng
SRN*-ATK	lặp
SRN*-ANT	lặt
SRN-E	lẹ
SRN-ET	lẹm
SRN-EN	lẹn
SRN-EJK	lẹo
SRN-ETK	lẹp
SRN-ENT	lẹt
SR-HSE	lẻ
SR-HSET	lẻm
SR-HSEN	lẻn
SR-HSEG	lẻng
SR-HSEJK	lẻo
SRN-SE	lẽ
SRN-SEN	lẽn
SRN-SEJK	lẽo
SR-SOEGK	lếch
SR-SOENT	lết
SR-SOEJG	lếu
SR-HOE	lề
SR-HOEK	lềnh
SR-HOEJG	lều
SR-HSOE	lể
SR-HSOEJG	lểu
SRN-SOE	lễ
SRN-OE	lệ
SRN-OEGK	lệch
SRN-OEK	lệnh
SRN-OENT	lệt
SR-HS*IK	lỉnh
SR-HS*IJG	lỉu
SRN*-I	lị
SRN-IE	lịa
SRN*-IGK	lịch
SRN*-IT	lịm
SRN*-IK	lịnh
SRN*-IJG	lịu
SRN-O	lọ
SRN-ONK	lọc
SRN-OJ	lọi
SRN-OT	lọm
SRN-ON	lọn
SRN-OG	lọng
SRN-OTK	lọp
SRN-ONT	lọt
SR-HSOJ	lỏi
SR-HSOT	lỏm
SR-HSON	lỏn
SR-HSOG	lỏng
SR-SOA	lố
SR-SOANK	lốc
SR-SOAJ	lối
SR-SOAT	lốm
SR-SOAN	lốn
SR-SOATK	lốp
SR-SOANT	lốt
SR-HOA	lồ
SR-HOAJ	lồi
SR-HOAT	lồm
SR-HOAN	lồn
SR-HOAG	lồng
SR-HSOA	lổ
SR-HSOAT	lổm
SR-HSOAN	lổn
SR-HSOAG	lổng
SRN-SOA	lỗ
SRN-SOAJ	lỗi
SRN-OA	lộ
SRN-OANK	lộc
SRN-OAJ	lội
SRN-OAT	lộm
SRN-OAN	lộn
SRN-OAG	lộng
SRN-OATK	lộp
SRN-OANT	lột
SR-SOY	lớ
SR-SOYJ	lới
SR-SOYN	lớn
SR-SOYTK	lớp
SR-SOYNT	lớt
SR-HOY	lờ
SR-HOYJ	lời
SR-HOYT	lờm
SR-HOYN	lờn
SR-HSOY	lở
SR-HSOYJ	lởi
SR-HSOYT	lởm
SR-HSOYN	lởn
SRN-SOY	lỡ
SRN-SOYJ	lỡi
SRN-SOYT	lỡm
SRN-OY	lợ
SRN-OYJ	lợi
SRN-OYT	lợm
SRN-OYN	lợn
SRN-OYTK	lợp
SRN-OYNT	lợt
SRN-IU	lụ
SRN-UO	lụa
SRN-IUNK	lục
SRN-IUJ	lụi
SRN-IUT	lụm
SRN-IUN	lụn
SRN-IUG	lụng
SRN-IUTK	lụp
SRN-IUNT	lụt
SR-HSIU	lủ
SR-HSUO	lủa
SR-HSIUJ	lủi
SR-HSIUT	lủm
SR-HSIUN	lủn
SR-HSIUG	lủng
SR-SEA	lứa
SR-SUANK	lức
SR-SUANT	lứt
SR-HUA	lừ
SR-HEA	lừa
SR-HUAG	lừng
SR-HSUA	lử
SR-HSEA	lửa
SR-HSUAG	lửng
SRN-SUA	lữ
SRN-SEA	lữa
SRN-SUAG	lững
SRN-UA	lự
SRN-EA	lựa
SRN-UANK	lực
SRN-UAG	lựng
SRN-UAJG	lựu
SRN-I	lỵ
RH-A	ma
RH-AJ	mai
RH-AN	man
RH-AG	mang
RH-AK	manh
RH-AJK	mao
RH-AJG	mau
RH-AJN	may
RH-E	me
RH-EN	men
RH-EJK	meo
RH*-I	mi
RH-IE	mia
RH*-IN	min
RH*-IK	minh
RH*-IJG	miu
RH-IEN	miên
RH-IEJG	miêu
RH-SIEN	miến
RH-SIEG	miếng
RH-SIENT	miết
RH-SIEJG	miếu
RH-HIEN	miền
RH-HIEJG	miều
RH-HSIEJG	miểu
RHN-SIEN	miễn
RHN-SIEJG	miễu
RHN-IEN	miện
RHN-IEG	miệng
RHN-IENT	miệt
RHN-IEJG	miệu
RH-O	mo
RH-UJN	moay
RH-OJ	moi
RH-OT	mom
RH-ON	mon
RH-OG	mong
RH*-OG	moong
RH-IU	mu
RH-UO	mua
RH-IUJ	mui
RH-IUN	mun
RH-IUG	mung
RH-UOJ	muôi
RH-UON	muôn
RH-UOG	muông
RH-SUOJ	muối
RH-SUON	muốn
RH-SUOG	muống
RH-SUONT	muốt
RH-HUOJ	muồi
RH-HUOG	muồng
RHN-SUOJ	muỗi
RHN-SUOT	muỗm
RHN-SUOG	muỗng
RHN-UOJ	muội
RHN-UON	muộn
RH-HA	mà
RH-HAJ	mài
RH-HAN	màn
RH-HAG	màng
RH-HAK	mành
RH-HAJK	mào
RH-HAJG	màu
RH-HAJN	mày
RH-SA	má
RH-SANK	mác
RH-SAGK	mách
RH-SAJ	mái
RH-SAT	mám
RH-SAN	mán
RH-SAG	máng
RH-SAK	mánh
RH-SAJK	máo
RH-SANT	mát
RH-SAJG	máu
RH-SAJN	máy
RH*-ET	mâm
RH*-EN	mân
RH*-EJG	mâu
RH*-EJN	mây
RHN-SA	mã
RHN-SAJ	mãi
RHN-SAN	mãn
RHN-SAG	mãng
RHN-SAK	mãnh
RHN-SAJK	mão
RH-HE	mè
RH-HET	mèm
RH-HEN	mèn
RH-HEG	mèng
RH-HEJK	mèo
RH-SE	mé
RH-SENK	méc
RH-SET	mém
RH-SEN	mén
RH-SEJK	méo
RH-SETK	mép
RH-SENT	mét
RH-OE	mê
RH-OEN	mên
RH-OEK	mênh
RH-H*I	mì
RH-H*IN	mìn
RH-H*IK	mình
RH-S*I	mí
RH-SIE	mía
RH-S*IGK	mích
RH-S*IT	mím
RH-S*ITK	míp
RH-S*INT	mít
RH-S*IJG	míu
RH-HO	mò
RH-HOJ	mòi
RH-HOT	mòm
RH-HON	mòn
RH-HOG	mòng
RH-SO	mó
RH-SONK	móc
RH-SOJ	mói
RH-SOT	móm
RH-SON	món
RH-SOG	móng
RH-SOTK	móp
RH-SONT	mót
RH-OA	mô
RH-OAJ	môi
RH-OAT	môm
RH-OAN	môn
RH-OAG	mông
RHN-SO	mõ
RHN-SOT	mõm
RH-HIU	mù
RH-HUO	mùa
RH-HIUJ	mùi
RH-HIUN	mùn
RH-HIUG	mùng
RH-SIU	mú
RH-SUO	múa
RH-SIUNK	múc
RH-SIUJ	múi
RH-SIUT	múm
RH-SIUN	mún
RH-SIUTK	múp
RH-SIUNT	mút
RH*-AT	măm
RH*-AN	măn
RH*-AG	măng
RHN-S*I	mĩ
RHN-S*IT	mĩm
RHN-SIU	mũ
RHN-SIUJ	mũi
RHN-SIUT	mũm
RH-OY	mơ
RH-OYJ	mơi
RH-OYN	mơn
RH-EA	mưa
RH-UAG	mưng
RH-UAJG	mưu
RH-EAJ	mươi
RH-EAG	mương
RH-SEAN	mướn
RH-SEATK	mướp
RH-SEANT	mướt
RH-HEAJ	mười
RH-HEAG	mường
RH-HSEAJ	mưởi
RH-HSEAJG	mưởu
RHN-EANK	mược
RHN-EAN	mượn
RHN-EANT	mượt
RHN-A	mạ
RHN-ANK	mạc
RHN-AGK	mạch
RHN-AJ	mại
RHN-AN	mạn
RHN-AG	mạng
RHN-AK	mạnh
RHN-AJK	mạo
RHN-ATK	mạp
RHN-ANT	mạt
RHN-AJN	mạy
RH-HSA	mả
RH-HSAJ	mải
RH-HSAN	mản
RH-HSAG	mảng
RH-HSAK	mảnh
RH-HSAJN	mảy
RH-S*EN	mấn
RH-S*ETK	mấp
RH-S*ENT	mất
RH-S*EJG	mấu
RH-S*EJN	mấy
RH-H*ET	mầm
RH-H*EN	mần
RH-H*EJG	mầu
RH-H*EJN	mầy
RH-HS*ET	mẩm
RH-HS*EN	mẩn
RH-HS*EJG	mẩu
RH-HS*EJN	mẩy
RHN-S*ET	mẫm
RHN-S*EN	mẫn
RHN-S*EJG	mẫu
RHN*-ET	mậm
RHN*-EN	mận
RHN*-ETK	mập
RHN*-ENT	mật
RHN*-EJG	mậu
RHN*-EJN	mậy
RH-S*ANK	mắc
RH-S*AT	mắm
RH-S*AN	mắn
RH-S*AG	mắng
RH-S*ANT	mắt
RH-H*AN	mằn
RH-HS*AN	mẳn
RHN*-ANK	mặc
RHN*-AN	mặn
RHN*-ANT	mặt
RHN-E	mẹ
RHN-EJK	mẹo
RHN-ETK	mẹp
RHN-ENT	mẹt
RH-HSE	mẻ
RHN-SE	mẽ
RH-SOE	mế
RH-SOEGK	mếch
RH-SOEN	mến
RH-SOEJG	mếu
RH-HOE	mề
RH-HOET	mềm
RH-HOEN	mền
RHN-SOE	mễ
RHN-OE	mệ
RHN-OEK	mệnh
RHN-OENT	mệt
RH-HS*I	mỉ
RH-HSIE	mỉa
RH-HS*IT	mỉm
RHN*-I	mị
RHN*-IGK	mịch
RHN*-IN	mịn
RHN*-INT	mịt
RHN-O	mọ
RHN-ONK	mọc
RHN-OJ	mọi
RHN-OT	mọm
RHN-ON	mọn
RHN-OG	mọng
RHN-OTK	mọp
RHN-ONT	mọt
RH-HSO	mỏ
RH-HSOJ	mỏi
RH-HSOT	mỏm
RH-HSOG	mỏng
RH-SOA	mố
RH-SOANK	mốc
RH-SOAJ	mối
RH-SOAG	mống
RH-SOANT	mốt
RH-HOA	mồ
RH-HOAJ	mồi
RH-HOAT	mồm
RH-HOAN	mồn
RH-HOAG	mồng
RH-HSOA	mổ
RH-HSOAG	mổng
RHN-SOA	mỗ
RHN-SOAJ	mỗi
RHN-OA	mộ
RHN-OANK	mộc
RHN-OAJ	mội
RHN-OAG	mộng
RHN-OANT	một
RH-SOY	mớ
RH-SOYJ	mới
RH-SOYT	mớm
RH-SOYN	mớn
RH-HOY	mờ
RH-HOYJ	mời
RH-HOYT	mờm
RH-HSOY	mở
RH-HSOYN	mởn
RHN-SOY	mỡ
RHN-OY	mợ
RHN-IU	mụ
RHN-IUNK	mục
RHN-IUJ	mụi
RHN-IUN	mụn
RHN-IUNT	mụt
RH-HSIU	mủ
RH-HSIUJ	mủi
RH-HSIUT	mủm
RH-HSIUN	mủn
RH-HSIUG	mủng
RH-SEA	mứa
RH-SUANK	mức
RH-SUANT	mứt
RH-SUAJG	mứu
RH-HUAG	mừng
RH-HSEA	mửa
RH-HSUAG	mửng
RHN-EA	mựa
RHN-UANK	mực
RHN-SI	mỹ
SRH-A	na
SRH-AJ	nai
SRH-AT	nam
SRH-AN	nan
SRH-AG	nang
SRH-AK	nanh
SRH-AJK	nao
SRH-AJN	nay
SRH-E	ne
SRH-ET	nem
SRH-EN	nen
SRH-EJK	neo
KR-A	nga
KR-AJ	ngai
KR-AN	ngan
KR-AG	ngang
KR-AJK	ngao
KR-AJG	ngau
KR-AJN	ngay
KR-E	nghe
KR-EN	nghen
KR*-I	nghi
KR*-IK	nghinh
KR*-IJG	nghiu
KR-IET	nghiêm
KR-IEN	nghiên
KR-IEG	nghiêng
KR-SIEN	nghiến
KR-HIEN	nghiền
KRN-SIET	nghiễm
KRN-IET	nghiệm
KRN-IEN	nghiện
KRN-IETK	nghiệp
KRN-IENT	nghiệt
KR-HE	nghè
KR-HEN	nghèn
KR-HEJK	nghèo
KR-SE	nghé
KR-SEN	nghén
KR-SENT	nghét
KR-OE	nghê
KR-OEK	nghênh
KR-OEJG	nghêu
KR-H*I	nghì
KR-H*IN	nghìn
KR-S*I	nghí
KR-SIE	nghía
KRN-S*I	nghĩ
KRN-SIE	nghĩa
KRN-S*IK	nghĩnh
KRN-E	nghẹ
KRN-EN	nghẹn
KRN-EJK	nghẹo
KRN-ENT	nghẹt
KR-HSEJK	nghẻo
KRN-SEN	nghẽn
KRN-SEJK	nghẽo
KR-SOEGK	nghếch
KR-HOE	nghề
KR-HOEJG	nghều
KR-HSOE	nghể
KR-HSOEN	nghển
KR-HSOEK	nghểnh
KR-HSOEJG	nghểu
KRN-SOE	nghễ
KRN-SOEK	nghễnh
KRN-SOEJG	nghễu
KRN-OE	nghệ
KRN-OEGK	nghệch
KRN-OEN	nghện
KRN-OEJG	nghệu
KR-HS*I	nghỉ
KR-HS*IT	nghỉm
KR-HS*IK	nghỉnh
KR-HS*IJG	nghỉu
KRN*-I	nghị
KRN*-IGK	nghịch
KRN*-INT	nghịt
KRN*-IJG	nghịu
KR-O	ngo
KR-U	ngoa
KR-UJ	ngoai
KR-UN	ngoan
KR-UJK	ngoao
KR-UJN	ngoay
KR-AY	ngoe
KR-AYN	ngoen
KR-OJ	ngoi
KR-ON	ngon
KR-HUJ	ngoài
KR-HUT	ngoàm
KR-SUNK	ngoác
KR-SUJ	ngoái
KR-SUJK	ngoáo
KR-SUTK	ngoáp
KR-SUJN	ngoáy
KRN-SU	ngoã
KRN-SUN	ngoãn
KR-HAYJK	ngoèo
KR-SAY	ngoé
KR-SAYJK	ngoéo
KR-SAYNT	ngoét
KRN-U	ngoạ
KRN-UNK	ngoạc
KRN-UJ	ngoại
KRN-UT	ngoạm
KRN-UN	ngoạn
KRN-UJN	ngoạy
KR-HSUJ	ngoải
KR-HSUK	ngoảnh
KR-HSUJN	ngoảy
KR-S*UNK	ngoắc
KR-S*UNT	ngoắt
KR-H*UN	ngoằn
KR-H*UG	ngoằng
KRN-S*UG	ngoẵng
KRN*-UNK	ngoặc
KRN*-UTK	ngoặp
KRN*-UNT	ngoặt
KRN-AYJK	ngoẹo
KR-HSAYN	ngoẻn
KR-HSAYJK	ngoẻo
KR-IU	ngu
KR-UY	nguy
KR-EYN	nguyên
KR-HEYN	nguyền
KRN-SEYN	nguyễn
KRN-EYN	nguyện
KRN-EYNT	nguyệt
KR*-YJN	nguây
KR-UOJ	nguôi
KR-SUYNT	nguýt
KR-HS*YJN	nguẩy
KRN*-YJN	nguậy
KR-SUEGK	nguếch
KRN-UEGK	nguệch
KR-HUON	nguồn
KRN-UOJ	nguội
KRN-UY	nguỵ
KR-HSUYJG	nguỷu
KR-HA	ngà
KR-HAJ	ngài
KR-HAT	ngàm
KR-HAN	ngàn
KR-HAG	ngàng
KR-HAK	ngành
KR-HAJK	ngào
KR-HAJG	ngàu
KR-HAJN	ngày
KR-SANK	ngác
KR-SAGK	ngách
KR-SAJ	ngái
KR-SAN	ngán
KR-SAG	ngáng
KR-SAJK	ngáo
KR-SATK	ngáp
KR-SANT	ngát
KR-SAJG	ngáu
KR-SAJN	ngáy
KR*-ET	ngâm
KR*-EN	ngân
KR*-EJG	ngâu
KR*-EJN	ngây
KRN-SA	ngã
KRN-SAJ	ngãi
KRN-SAG	ngãng
KRN-SAJK	ngão
KR-HO	ngò
KR-HOJ	ngòi
KR-HOT	ngòm
KR-HOG	ngòng
KR-SO	ngó
KR-SONK	ngóc
KR-SOJ	ngói
KR-SOT	ngóm
KR-SON	ngón
KR-SOG	ngóng
KR-SOTK	ngóp
KR-SONT	ngót
KR-OA	ngô
KR-OAJ	ngôi
KR-OAN	ngôn
KR-OAG	ngông
KRN-SO	ngõ
KRN-SOT	ngõm
KRN-SOG	ngõng
KR-HIU	ngù
KR-HIUJ	ngùi
KR-HIUN	ngùn
KR-HIUG	ngùng
KR-SIUNK	ngúc
KR-SIUN	ngún
KR-SIUG	ngúng
KR-SIUNT	ngút
KR*-AT	ngăm
KR*-AN	ngăn
KRN-SIU	ngũ
KR-OY	ngơ
KR-OYJ	ngơi
KR-OYT	ngơm
KR-UA	ngư
KR-EA	ngưa
KR-UAG	ngưng
KR-UAJG	ngưu
KR-EAJ	ngươi
KR-SEANK	ngước
KR-HEAJ	người
KR-HEAG	ngường
KR-HSEAG	ngưởng
KRN-SEAG	ngưỡng
KRN-EANK	ngược
KRN-EAG	ngượng
KRN-ANK	ngạc
KRN-AGK	ngạch
KRN-AJ	ngại
KRN-AN	ngạn
KRN-AK	ngạnh
KRN-AJK	ngạo
KRN-ANT	ngạt
KR-HSA	ngả
KR-HSAJ	ngải
KR-HSAK	ngảnh
KR-S*ENK	ngấc
KR-S*ET	ngấm
KR-S*EN	ngấn
KR-S*ETK	ngấp
KR-S*ENT	ngất
KR-S*EJG	ngấu
KR-S*EJN	ngấy
KR-H*ET	ngầm
KR-H*EN	ngần
KR-H*EJG	ngầu
KR-H*EJN	ngầy
KR-HS*ET	ngẩm
KR-HS*EN	ngẩn
KR-HS*EG	ngẩng
KRN-S*ET	ngẫm
KRN-S*EG	ngẫng
KRN-S*EJG	ngẫu
KRN*-ET	ngậm
KRN*-ETK	ngập
KRN*-ENT	ngật
KRN*-EJG	ngậu
KRN*-EJN	ngậy
KR-S*ANK	ngắc
KR-S*AT	ngắm
KR-S*AN	ngắn
KR-S*ANT	ngắt
KR-H*AN	ngằn
KR-HS*AG	ngẳng
KRN-S*AG	ngẵng
KRN*-ANT	ngặt
KRN-O	ngọ
KRN-ONK	ngọc
KRN-ON	ngọn
KRN-OG	ngọng
KRN-ONT	ngọt
KR-HSO	ngỏ
KR-HSOT	ngỏm
KR-HSON	ngỏn
KR-HSOG	ngỏng
KR-SOA	ngố
KR-SOANK	ngốc
KR-SOAN	ngốn
KR-SOANT	ngốt
KR-HOA	ngồ
KR-HOAJ	ngồi
KR-HOAN	ngồn
KR-HOAG	ngồng
KR-HSOA	ngổ
KR-HSOAT	ngổm
KR-HSOAN	ngổn
KR-HSOAG	ngổng
KRN-SOA	ngỗ
KRN-SOAG	ngỗng
KRN-OA	ngộ
KRN-OANK	ngộc
KRN-OAN	ngộn
KRN-OANT	ngột
KR-SOY	ngớ
KR-SOYN	ngớn
KR-SOYTK	ngớp
KR-SOYNT	ngớt
KR-HOY	ngờ
KR-HOYJ	ngời
KR-HOYT	ngờm
KRN-SOY	ngỡ
KRN-OY	ngợ
KRN-OYJ	ngợi
KRN-OYT	ngợm
KRN-OYTK	ngợp
KRN-IU	ngụ
KRN-UO	ngụa
KRN-IUNK	ngục
KRN-IUT	ngụm
KRN-IUTK	ngụp
KRN-IUNT	ngụt
KR-HSIU	ngủ
KR-HSIUJ	ngủi
KR-HSIUT	ngủm
KR-HSIUN	ngủn
KR-HSIUG	ngủng
KR-SUA	ngứ
KR-SEA	ngứa
KR-SUANT	ngứt
KR-HUA	ngừ
KR-HEA	ngừa
KR-HUAG	ngừng
KR-HSEA	ngửa
KR-HSUAJ	ngửi
KR-HSUAG	ngửng
KRN-SUA	ngữ
KRN-UA	ngự
KRN-EA	ngựa
KRN-UANK	ngực
TK-A	nha
TK-AJ	nhai
TK-AT	nham
TK-AN	nhan
TK-AG	nhang
TK-AK	nhanh
TK-AJK	nhao
TK-AJG	nhau
TK-AJN	nhay
TK-E	nhe
TK-ET	nhem
TK-EN	nhen
TK-EJK	nheo
TK*-I	nhi
TK*-IK	nhinh
TK-IEN	nhiên
TK-IEJG	nhiêu
TK-SIENK	nhiếc
TK-SIETK	nhiếp
TK-HIEJG	nhiều
TKN-SIET	nhiễm
TKN-SIEN	nhiễn
TKN-SIEJG	nhiễu
TKN-IET	nhiệm
TKN-IENT	nhiệt
TK-O	nho
TK-UJ	nhoai
TK-UJN	nhoay
TK-AY	nhoe
TK-AYN	nhoen
TK-OJ	nhoi
TK-OT	nhom
TK-ON	nhon
TK-OG	nhong
TK-HU	nhoà
TK-HUJ	nhoài
TK-HUT	nhoàm
TK-HUG	nhoàng
TK-SU	nhoá
TK-SUG	nhoáng
TK-SUJN	nhoáy
TK-HAY	nhoè
TK-HAYN	nhoèn
TK-SAYNT	nhoét
TKN-UG	nhoạng
TKN-AYNT	nhoẹt
TK-HSAYN	nhoẻn
TK-IU	nhu
TK-IUT	nhum
TK-IUG	nhung
TKN-SEYN	nhuyễn
TK-UOT	nhuôm
TK-H*YN	nhuần
TKN*-YN	nhuận
TKN-UE	nhuệ
TK-SUONK	nhuốc
TK-SUOT	nhuốm
TKN-UOT	nhuộm
TKN-UY	nhuỵ
TK-HA	nhà
TK-HAJ	nhài
TK-HAT	nhàm
TK-HAN	nhàn
TK-HAG	nhàng
TK-HAK	nhành
TK-HAJK	nhào
TK-HAJG	nhàu
TK-SA	nhá
TK-SANK	nhác
TK-SAGK	nhách
TK-SAJ	nhái
TK-SAT	nhám
TK-SAK	nhánh
TK-SAJK	nháo
TK-SATK	nháp
TK-SANT	nhát
TK-SAJN	nháy
TK*-ET	nhâm
TK*-EN	nhân
TK*-EG	nhâng
TK*-EJG	nhâu
TK*-EJN	nhây
TKN-SA	nhã
TKN-SAJ	nhãi
TKN-SAN	nhãn
TKN-SAG	nhãng
TKN-SAJK	nhão
TK-HE	nhè
TK-HET	nhèm
TK-HEJK	nhèo
TK-SE	nhé
TK-SEN	nhén
TK-SEJK	nhéo
TK-SETK	nhép
TK-SENT	nhét
TK-OEK	nhênh
TK-H*I	nhì
TK-H*IN	nhìn
TK-S*I	nhí
TK-SIE	nhía
TK-S*IGK	nhích
TK-S*IT	nhím
TK-S*IN	nhín
TK-S*IK	nhính
TK-S*ITK	nhíp
TK-S*INT	nhít
TK-S*IJG	nhíu
TK-HOT	nhòm
TK-HOG	nhòng
TK-SO	nhó
TK-SONK	nhóc
TK-SOJ	nhói
TK-SOT	nhóm
TK-SON	nhón
TK-SOG	nhóng
TK-SOTK	nhóp
TK-SONT	nhót
TK-OA	nhô
TK-OAJ	nhôi
TK-OAT	nhôm
TK-OAN	nhôn
TK-OAG	nhông
TKN-SOT	nhõm
TKN-SOG	nhõng
TK-HIUJ	nhùi
TK-HIUG	nhùng
TK-SIU	nhú
TK-SUO	nhúa
TK-SIUNK	nhúc
TK-SIUJ	nhúi
TK-SIUT	nhúm
TK-SIUN	nhún
TK-SIUG	nhúng
TK-SIUNT	nhút
TK*-AT	nhăm
TK*-AN	nhăn
TK*-AG	nhăng
TKN-S*I	nhĩ
TKN-SIU	nhũ
TKN-SIUN	nhũn
TKN-SIUG	nhũng
TK-OY	nhơ
TK-OYJ	nhơi
TK-OYT	nhơm
TK-OYN	nhơn
TK-UA	như
TK-UAG	nhưng
TK-EAG	nhương
TK-SEAN	nhướn
TK-SEAG	nhướng
TK-HEAG	nhường
TKN-SEAG	nhưỡng
TKN-EANK	nhược
TKN-EAG	nhượng
TKN-A	nhạ
TKN-ANK	nhạc
TKN-AJ	nhại
TKN-AN	nhạn
TKN-AG	nhạng
TKN-AK	nhạnh
TKN-AJK	nhạo
TKN-ATK	nhạp
TKN-ANT	nhạt
TKN-AJN	nhạy
TK-HSA	nhả
TK-HSAJ	nhải
TK-HSAT	nhảm
TK-HSAN	nhản
TK-HSAK	nhảnh
TK-HSAJK	nhảo
TK-HSAJG	nhảu
TK-HSAJN	nhảy
TK-S*ENK	nhấc
TK-S*ET	nhấm
TK-S*EN	nhấn
TK-S*ETK	nhấp
TK-S*ENT	nhất
TK-H*ET	nhầm
TK-H*EN	nhần
TK-H*EJG	nhầu
TK-H*EJN	nhầy
TK-HS*ET	nhẩm
TK-HS*EN	nhẩn
TK-HS*EJG	nhẩu
TK-HS*EJN	nhẩy
TKN-S*EN	nhẫn
TKN-S*EJN	nhẫy
TKN*-ET	nhậm
TKN*-EN	nhận
TKN*-ETK	nhập
TKN*-ENT	nhật
TKN*-EJG	nhậu
TKN*-EJN	nhậy
TK-S*ANK	nhắc
TK-S*AT	nhắm
TK-S*AN	nhắn
TK-S*AG	nhắng
TK-S*ATK	nhắp
TK-S*ANT	nhắt
TK-H*AT	nhằm
TK-H*AN	nhằn
TK-H*AG	nhằng
TK-HS*AN	nhẳn
TK-HS*AG	nhẳng
TKN-S*AN	nhẵn
TKN-S*AG	nhẵng
TKN*-AT	nhặm
TKN*-AN	nhặn
TKN*-AG	nhặng
TKN*-ANT	nhặt
TKN-E	nhẹ
TKN-ET	nhẹm
TKN-EN	nhẹn
TKN-EJK	nhẹo
TKN-ETK	nhẹp
TKN-ENT	nhẹt
TK-HSE	nhẻ
TK-HSET	nhẻm
TKN-SE	nhẽ
TKN-SEJK	nhẽo
TK-SOEGK	nhếch
TK-SOEJG	nhếu
TK-HSOE	nhể
TK-HSOEJG	nhểu
TKN-SOE	nhễ
TKN-SOEJG	nhễu
TKN-OEGK	nhệch
TKN-OEN	nhện
TK-HS*I	nhỉ
TK-HS*IK	nhỉnh
TK-HS*IJG	nhỉu
TKN*-I	nhị
TKN*-IN	nhịn
TKN*-ITK	nhịp
TKN*-INT	nhịt
TKN*-IJG	nhịu
TKN-O	nhọ
TKN-ONK	nhọc
TKN-ON	nhọn
TKN-ONT	nhọt
TK-HSO	nhỏ
TK-HSOT	nhỏm
TK-HSOG	nhỏng
TK-SOA	nhố
TK-SOANK	nhốc
TK-SOAJ	nhối
TK-SOAN	nhốn
TK-SOANT	nhốt
TK-HOAJ	nhồi
TK-HOAT	nhồm
TK-HOAN	nhồn
TK-HOAG	nhồng
TK-HSOA	nhổ
TK-HSOAT	nhổm
TK-HSOAN	nhổn
TK-HSOAG	nhổng
TKN-SOAG	nhỗng
TKN-OAJ	nhội
TKN-OAN	nhộn
TKN-OAG	nhộng
TKN-OANT	nhột
TK-SOY	nhớ
TK-SOYT	nhớm
TK-SOYN	nhớn
TK-SOYTK	nhớp
TK-SOYNT	nhớt
TK-HOY	nhờ
TK-HOYJ	nhời
TK-HOYT	nhờm
TK-HOYN	nhờn
TK-HSOY	nhở
TK-HSOYJ	nhởi
TK-HSOYN	nhởn
TKN-SOY	nhỡ
TKN-SOYN	nhỡn
TKN-OY	nhợ
TKN-OYNT	nhợt
TKN-IU	nhụ
TKN-UO	nhụa
TKN-IUNK	nhục
TKN-IUJ	nhụi
TKN-IUG	nhụng
TKN-IUNT	nhụt
TK-HSIU	nhủ
TK-HSIUJ	nhủi
TK-HSIUN	nhủn
TK-HSIUG	nhủng
TK-SUA	nhứ
TK-SUANK	nhức
TK-SUANT	nhứt
TK-HUA	nhừ
TK-HSUA	nhử
TKN-SUAG	những
TKN-UA	nhự
TKN-EA	nhựa
TKN-UANT	nhựt
SRH*-I	ni
SRH-IE	nia
SRH*-IN	nin
SRH*-IK	ninh
SRH*-IJG	niu
SRH-IET	niêm
SRH-IEN	niên
SRH-IEJG	niêu
SRH-SIENT	niết
SRH-HIET	niềm
SRH-HIEG	niềng
SRHN-SIEG	niễng
SRHN-IET	niệm
SRHN-IENT	niệt
SRHN-IEJG	niệu
SRH-O	no
SRH-OJ	noi
SRH-OT	nom
SRH-ON	non
SRH-OG	nong
SRHN-SUN	noãn
SRH-HSUN	noản
SRH-IU	nu
SRH-UO	nua
SRH-IUJ	nui
SRH-IUG	nung
SRH-UOJ	nuôi
SRH-UOG	nuông
SRH-SUOJ	nuối
SRH-SUOT	nuốm
SRH-SUONT	nuốt
SRHN-UONK	nuộc
SRHN-UONT	nuột
SRH-HA	nà
SRH-HAJ	nài
SRH-HAN	nàn
SRH-HAG	nàng
SRH-HAK	nành
SRH-HAJK	nào
SRH-HAJN	này
SRH-SA	ná
SRH-SANK	nác
SRH-SAGK	nách
SRH-SAJ	nái
SRH-SAT	nám
SRH-SAN	nán
SRH-SAG	náng
SRH-SAK	nánh
SRH-SAJK	náo
SRH-SATK	náp
SRH-SANT	nát
SRH-SAJG	náu
SRH-SAJN	náy
SRH*-EG	nâng
SRH*-EJG	nâu
SRH*-EJN	nây
SRHN-SA	nã
SRHN-SAJ	nãi
SRHN-SAJK	não
SRHN-SAJN	nãy
SRH-HE	nè
SRH-HEJK	nèo
SRH-SE	né
SRH-SET	ném
SRH-SEN	nén
SRH-SEJK	néo
SRH-SETK	nép
SRH-SENT	nét
SRH-OE	nê
SRH-OET	nêm
SRH-OEN	nên
SRH-OEK	nênh
SRH-OEJG	nêu
SRH-H*I	nì
SRH-S*IGK	ních
SRH-S*IN	nín
SRH-S*IK	nính
SRH-S*ITK	níp
SRH-S*INT	nít
SRH-S*IJG	níu
SRH-HO	nò
SRH-HOJ	nòi
SRH-HOT	nòm
SRH-HOG	nòng
SRH-SO	nó
SRH-SONK	nóc
SRH-SOJ	nói
SRH-SOT	nóm
SRH-SON	nón
SRH-SOG	nóng
SRH-SOTK	nóp
SRH-SONT	nót
SRH-OA	nô
SRH-OAJ	nôi
SRH-OAT	nôm
SRH-OAN	nôn
SRH-OAG	nông
SRHN-SO	nõ
SRHN-SON	nõn
SRH-HIUJ	nùi
SRH-HIUN	nùn
SRH-HIUG	nùng
SRH-SIUNK	núc
SRH-SIUJ	núi
SRH-SIUT	núm
SRH-SIUG	núng
SRH-SIUTK	núp
SRH-SIUNT	nút
SRH*-AT	năm
SRH*-AN	năn
SRH*-AG	năng
SRHN-SIE	nĩa
SRHN-SIUG	nũng
SRH-OY	nơ
SRH-OYJ	nơi
SRH-OYT	nơm
SRH-UA	nư
SRH-EA	nưa
SRH-EAG	nương
SRH-SEANK	nước
SRH-SEAG	nướng
SRH-SEAJG	nướu
SRH-HEAT	nườm
SRH-HEAG	nường
SRHN-EATK	nượp
SRHN-A	nạ
SRHN-ANK	nạc
SRHN-AJ	nại
SRHN-AT	nạm
SRHN-AN	nạn
SRHN-AG	nạng
SRHN-AK	nạnh
SRHN-AJK	nạo
SRHN-ATK	nạp
SRHN-ANT	nạt
SRHN-AJN	nạy
SRH-HSA	nả
SRH-HSAJ	nải
SRH-HSAN	nản
SRH-HSAJK	nảo
SRH-HSAJN	nảy
SRH-S*ENK	nấc
SRH-S*ET	nấm
SRH-S*EN	nấn
SRH-S*EG	nấng
SRH-S*ETK	nấp
SRH-S*EJG	nấu
SRH-S*EJN	nấy
SRH-H*ET	nầm
SRH-H*EN	nần
SRH-H*EJN	nầy
SRH-HS*EG	nẩng
SRH-HS*EJN	nẩy
SRHN-S*EN	nẫn
SRHN-S*EG	nẫng
SRHN-S*EJG	nẫu
SRHN-S*EJN	nẫy
SRHN*-ET	nậm
SRHN*-EG	nậng
SRHN*-ETK	nập
SRHN*-EJG	nậu
SRHN*-EJN	nậy
SRH-S*ANK	nắc
SRH-S*AT	nắm
SRH-S*AN	nắn
SRH-S*AG	nắng
SRH-S*ATK	nắp
SRH-H*AT	nằm
SRH-H*AG	nằng
SRHN*-ANK	nặc
SRHN*-AN	nặn
SRHN*-AG	nặng
SRHN-E	nẹ
SRHN-ETK	nẹp
SRHN-ENT	nẹt
SRH-HSE	nẻ
SRH-HSEJK	nẻo
SRH-SOET	nếm
SRH-SOEN	nến
SRH-SOETK	nếp
SRH-SOENT	nết
SRH-SOEJG	nếu
SRH-HOE	nề
SRH-HOEN	nền
SRH-HSOE	nể
SRHN-OE	nệ
SRHN-OET	nệm
SRHN-OEN	nện
SRH-HS*I	nỉ
SRHN*-IGK	nịch
SRHN*-IK	nịnh
SRHN*-INT	nịt
SRHN*-IJG	nịu
SRHN-O	nọ
SRHN-ONK	nọc
SRHN-ON	nọn
SRHN-OG	nọng
SRHN-ONT	nọt
SRH-HSO	nỏ
SRH-HSOT	nỏm
SRH-SOANK	nốc
SRH-SOAJ	nối
SRH-SOAT	nốm
SRH-SOAG	nống
SRH-SOANT	nốt
SRH-HOAJ	nồi
SRH-HOAT	nồm
SRH-HOAG	nồng
SRH-HSOA	nổ
SRH-HSOAJ	nổi
SRH-HSOAG	nổng
SRHN-SOA	nỗ
SRHN-SOAJ	nỗi
SRHN-SOAG	nỗng
SRHN-OA	nộ
SRHN-OAJ	nội
SRHN-OAT	nộm
SRHN-OAN	nộn
SRHN-OAG	nộng
SRHN-OATK	nộp
SRHN-OANT	nột
SRH-SOY	nớ
SRH-SOYJ	nới
SRH-SOYTK	nớp
SRH-SOYNT	nớt
SRH-HOYT	nờm
SRH-HSOY	nở
SRHN-SOY	nỡ
SRHN-SOYT	nỡm
SRHN-OY	nợ
SRHN-OYTK	nợp
SRHN-IU	nụ
SRHN-IUNK	nục
SRH-HSUO	nủa
SRH-SEA	nứa
SRH-SUANK	nức
SRH-SUANT	nứt
SRH-HSEA	nửa
SRHN-SUA	nữ
SRHN-SEA	nữa
SRHN-UA	nự
SRHN-UANK	nực
SRHN-UAG	nựng
-O	o
-U	oa
-UJ	oai
-UN	oan
-UG	oang
-UK	oanh
-AY	oe
-OJ	oi
-OT	om
-OG	ong
-HU	oà
-HUJ	oài
-HUG	oàng
-HUK	oành
-SUGK	oách
-SUJ	oái
-SUN	oán
-SUK	oánh
-SUNT	oát
-SAY	oé
*-UT	oăm
N-UGK	oạch
N-UJ	oại
N-UTK	oạp
-HSUJ	oải
-HSUN	oản
-S*UNT	oắt
-H*UN	oằn
-HS*UG	oẳng
N*-UNT	oặt
N-AY	oẹ
-HSAY	oẻ
SPH-A	pa
SPH-AN	pan
SPH-AK	panh
SPH-AJK	pao
SKH-A	pha
SKH-AJ	phai
SKH-AN	phan
SKH-AG	phang
SKH-AK	phanh
SKH-AJK	phao
SKH-AJG	phau
SKH-AJN	phay
SKH-E	phe
SKH-EN	phen
SKH-EJK	pheo
SKH*-I	phi
SKH*-IT	phim
SKH*-IN	phin
SKH*-IK	phinh
SKH*-IJG	phiu
SKH-IEN	phiên
SKH-IEJG	phiêu
SKH-SIET	phiếm
SKH-SIEN	phiến
SKH-SIENT	phiết
SKH-SIEJG	phiếu
SKH-HIEN	phiền
SKHN-IEN	phiện
SKHN-IENT	phiệt
SKHN-IEJG	phiệu
SKH-O	pho
SKH-OJ	phoi
SKH-OG	phong
SKH-IU	phu
SKH-UO	phua
SKH-IUJ	phui
SKH-IUN	phun
SKH-IUG	phung
SKH-UY	phuy
SKH-HA	phà
SKH-HAT	phàm
SKH-HAN	phàn
SKH-HAG	phàng
SKH-HAK	phành
SKH-HAJK	phào
SKH-SA	phá
SKH-SANK	phác
SKH-SAGK	phách
SKH-SAJ	phái
SKH-SAN	phán
SKH-SAJK	pháo
SKH-SATK	pháp
SKH-SANT	phát
SKH*-EN	phân
SKH*-EJN	phây
SKH-HE	phè
SKH-HEN	phèn
SKH-HEG	phèng
SKH-HEJK	phèo
SKH-SENK	phéc
SKH-SEG	phéng
SKH-SETK	phép
SKH-SENT	phét
SKH-OE	phê
SKH-OEN	phên
SKH-H*I	phì
SKH-HIE	phìa
SKH-H*IK	phình
SKH-S*I	phí
SKH-SIE	phía
SKH-S*IGK	phích
SKH-S*IT	phím
SKH-S*IK	phính
SKH-HO	phò
SKH-HOJ	phòi
SKH-HOT	phòm
SKH-HOG	phòng
SKH-SO	phó
SKH-SONK	phóc
SKH-SOG	phóng
SKH-SONT	phót
SKH-OA	phô
SKH-OAJ	phôi
SKH-OAT	phôm
SKH-OAN	phôn
SKH-OAG	phông
SKH-HIU	phù
SKH-HIUN	phùn
SKH-HIUG	phùng
SKH-SIU	phú
SKH-SIUNK	phúc
SKH-SIUN	phún
SKH-SIUG	phúng
SKH-SIUNT	phút
SKH*-AT	phăm
SKH*-AN	phăn
SKH*-AG	phăng
SKHN-S*IK	phĩnh
SKHN-SIU	phũ
SKH-OY	phơ
SKH-OYJ	phơi
SKH-OYN	phơn
SKH-UAG	phưng
SKH-EAG	phương
SKH-SEANK	phước
SKH-SEAN	phướn
SKH-SEAG	phướng
SKH-HEAG	phường
SKH-HSEAN	phưởn
SKHN-SEAN	phưỡn
SKHN-EAG	phượng
SKHN-ANK	phạc
SKHN-AGK	phạch
SKHN-AT	phạm
SKHN-AN	phạn
SKHN-ANT	phạt
SKH-HSA	phả
SKH-HSAJ	phải
SKH-HSAN	phản
SKH-HSAG	phảng
SKH-HSAJN	phảy
SKH-S*EN	phấn
SKH-S*ETK	phấp
SKH-S*ENT	phất
SKH-H*ET	phầm
SKH-H*EN	phần
SKH-HS*ET	phẩm
SKH-HS*EJN	phẩy
SKHN-S*EN	phẫn
SKHN-S*EJG	phẫu
SKHN*-EN	phận
SKHN*-ETK	phập
SKHN*-ENT	phật
SKH-S*ANK	phắc
SKH-S*ATK	phắp
SKH-S*ANT	phắt
SKH-HS*AG	phẳng
SKH-SOE	phế
SKH-SOEGK	phếch
SKH-SOENT	phết
SKH-SOEJG	phếu
SKH-HOE	phề
SKH-HOEJG	phều
SKHN-SOEJG	phễu
SKHN-OE	phệ
SKHN-OEK	phệnh
SKHN-OENT	phệt
SKH-HS*I	phỉ
SKH-HS*IK	phỉnh
SKHN*-I	phị
SKHN-IE	phịa
SKHN*-IGK	phịch
SKHN*-IJG	phịu
SKHN-ONT	phọt
SKH-HSOT	phỏm
SKH-HSOG	phỏng
SKH-SOA	phố
SKH-SOANK	phốc
SKH-SOAJ	phối
SKH-SOATK	phốp
SKH-SOANT	phốt
SKH-HOAN	phồn
SKH-HOAG	phồng
SKH-HSOA	phổ
SKH-HSOAJ	phổi
SKH-HSOAG	phổng
SKHN-SOAG	phỗng
SKHN-OAG	phộng
SKH-SOY	phớ
SKH-SOYJ	phới
SKH-SOYN	phớn
SKH-SOYNT	phớt
SKH-HOY	phờ
SKH-HSOY	phở
SKH-HSOYN	phởn
SKHN-SOYN	phỡn
SKHN-IU	phụ
SKHN-IUNK	phục
SKHN-IUG	phụng
SKHN-IUNT	phụt
SKH-HSIU	phủ
SKH-HSIUJ	phủi
SKH-SEA	phứa
SKH-SUANK	phức
SKH-SUANT	phứt
SKH-HUAG	phừng
SKHN-EA	phựa
SPH*-I	pi
SPH*-IN	pin
SPH-OT	pom
SPH-IU	pu
SPH-SUONK	puốc
SPH-OE	pê
SPH-S*INT	pít
SPH-OA	pô
SPHN-IE	pịa
SPHN-UO	pụa
STK-U	qua
STK-UJ	quai
STK-UN	quan
STK-UG	quang
STK-UK	quanh
STK-UJK	quao
STK-UJG	quau
STK-UJN	quay
STK-AY	que
STK-AYN	quen
STK-AYJK	queo
STK-UY	quy
STK-EYN	quyên
STK-SEYN	quyến
STK-SEYNT	quyết
STK-HEYN	quyền
STK-HSEYN	quyển
STKN-EYN	quyện
STKN-EYNT	quyệt
STK-HU	quà
STK-HUJ	quài
STK-HUN	quàn
STK-HUG	quàng
STK-HUK	quành
STK-HUJK	quào
STK-HUJG	quàu
STK-HUJN	quày
STK-SU	quá
STK-SUNK	quác
STK-SUGK	quách
STK-SUJ	quái
STK-SUN	quán
STK-SUG	quáng
STK-SUK	quánh
STK-SUJK	quáo
STK-SUNT	quát
STK-SUJG	quáu
STK-SUJN	quáy
STK*-YN	quân
STK*-YJN	quây
STKN-SU	quã
STKN-SUJ	quãi
STKN-SUN	quãn
STKN-SUG	quãng
STKN-SUK	quãnh
STKN-SUJK	quão
STKN-SUJG	quãu
STKN-SUJN	quãy
STK-HAY	què
STK-HAYN	quèn
STK-HAYJK	quèo
STK-SAY	qué
STK-SAYN	quén
STK-SAYJK	quéo
STK-SAYNT	quét
STK-UE	quê
STK-UEN	quên
STK-SUY	quý
STK-SUYGK	quých
STK-SUYK	quýnh
STK-SUYNT	quýt
STK*-UT	quăm
STK*-UN	quăn
STK*-UG	quăng
STK-Y	quơ
STKN-U	quạ
STKN-UNK	quạc
STKN-UGK	quạch
STKN-UJ	quại
STKN-UN	quạn
STKN-UG	quạng
STKN-UK	quạnh
STKN-UJK	quạo
STKN-UNT	quạt
STKN-UJG	quạu
STKN-UJN	quạy
STK-HSU	quả
STK-HSUJ	quải
STK-HSUN	quản
STK-HSUG	quảng
STK-HSUK	quảnh
STK-HSUJK	quảo
STK-HSUJG	quảu
STK-HSUJN	quảy
STK-S*YNK	quấc
STK-S*YN	quấn
STK-S*YNT	quất
STK-S*YJN	quấy
STK-H*YN	quần
STK-H*YG	quầng
STK-H*YJN	quầy
STK-HS*YN	quẩn
STK-HS*YG	quẩng
STK-HS*YJN	quẩy
STKN-S*YN	quẫn
STKN-S*YG	quẫng
STKN-S*YJN	quẫy
STKN*-YN	quận
STKN*-YNT	quật
STKN*-YJN	quậy
STK-S*UNK	quắc
STK-S*UT	quắm
STK-S*UN	quắn
STK-S*UTK	quắp
STK-S*UNT	quắt
STK-H*UT	quằm
STK-H*UN	quằn
STK-HS*UG	quẳng
STKN*-UNK	quặc
STKN*-UT	quặm
STKN*-UN	quặn
STKN*-UG	quặng
STKN*-UTK	quặp
STKN*-UNT	quặt
STKN-AYJK	quẹo
STKN-AYNT	quẹt
STK-HSAY	quẻ
STKN-SAY	quẽ
STK-SUE	quế
STK-SUENT	quết
STK-HUEJG	quều
STK-HSUEN	quển
STKN-UE	quệ
STKN-UEGK	quệch
STKN-UEN	quện
STKN-UENT	quệt
STK-SUONK	quốc
STK-SY	quớ
STK-HY	quờ
STK-HSY	quở
STK-HUY	quỳ
STK-HUYK	quỳnh
STKN-UY	quỵ
STKN-UYTK	quỵp
STKN-UYNT	quỵt
STK-HSUY	quỷ
STK-HSUYK	quỷnh
STKN-SUY	quỹ
R-A	ra
R-AJ	rai
R-AT	ram
R-AN	ran
R-AG	rang
R-AK	ranh
R-AJK	rao
R-AJG	rau
R-AJN	ray
R-E	re
R-EN	ren
R-EG	reng
R-EJK	reo
R*-I	ri
R-IE	ria
R*-IT	rim
R*-IN	rin
R*-IK	rinh
R*-IJG	riu
R-IEN	riên
R-IEG	riêng
R-IEJG	riêu
R-SIENT	riết
R-SIEJG	riếu
R-HIET	riềm
R-HIEG	riềng
RN-SIEJG	riễu
RN-IENT	riệt
R-O	ro
R-U	roa
R-OJ	roi
R-OG	rong
RN-UNT	roạt
R-IU	ru
R-UO	rua
R-IUJ	rui
R-IUT	rum
R-IUN	run
R-IUG	rung
R-UON	ruôn
R-SUONK	ruốc
R-SUOJ	ruối
R-SUONT	ruốt
R-HUOJ	ruồi
R-HUOG	ruồng
R-HSUOJ	ruổi
RN-SUOG	ruỗng
RN-UOT	ruộm
RN-UOG	ruộng
RN-UONT	ruột
R-HA	rà
R-HAJ	rài
R-HAN	ràn
R-HAG	ràng
R-HAK	rành
R-HAJK	rào
R-HAJN	rày
R-SA	rá
R-SANK	rác
R-SAGK	rách
R-SAJ	rái
R-SAT	rám
R-SAN	rán
R-SAG	ráng
R-SAJK	ráo
R-SATK	ráp
R-SANT	rát
R-SAJG	ráu
R-SAJN	ráy
R*-ET	râm
R*-EN	rân
R*-EJG	râu
R*-EJN	rây
RN-SA	rã
RN-SAJ	rãi
RN-SAK	rãnh
RN-SAJK	rão
RN-SAJN	rãy
R-HE	rè
R-HET	rèm
R-HEN	rèn
R-SE	ré
R-SEN	rén
R-SEJK	réo
R-SENT	rét
R-OE	rê
R-OET	rêm
R-OEN	rên
R-OEJG	rêu
R-H*I	rì
R-HIE	rìa
R-H*IK	rình
R-H*IJG	rìu
R-S*I	rí
R-S*IGK	rích
R-S*INT	rít
R-S*IJG	ríu
R-HO	rò
R-HOJ	ròi
R-HOT	ròm
R-HON	ròn
R-HOG	ròng
R-SO	ró
R-SONK	róc
R-SOJ	rói
R-SOT	róm
R-SON	rón
R-SOG	róng
R-SONT	rót
R-OA	rô
R-OAT	rôm
R-OAG	rông
RN-SO	rõ
RN-SOJ	rõi
RN-SOT	rõm
R-HIU	rù
R-HUO	rùa
R-HIUT	rùm
R-HIUN	rùn
R-HIUG	rùng
R-SIU	rú
R-SIUNK	rúc
R-SIUT	rúm
R-SIUN	rún
R-SIUG	rúng
R-SIUTK	rúp
R-SIUNT	rút
R*-AT	răm
R*-AN	răn
R*-AG	răng
RN-S*I	rĩ
RN-S*IN	rĩn
RN-SIU	rũ
RN-SUO	rũa
R-OY	rơ
R-OYJ	rơi
R-OYT	rơm
R-OYN	rơn
R-EA	rưa
R-UAG	rưng
R-EAJ	rươi
R-EAG	rương
R-SEANK	rước
R-SEAJ	rưới
R-SEAT	rướm
R-SEAN	rướn
R-HEAJ	rười
R-HEAT	rườm
R-HEAG	rường
R-HSEAJ	rưởi
RN-SEAJ	rưỡi
RN-EAJ	rượi
RN-EAN	rượn
RN-EANT	rượt
RN-EAJG	rượu
RN-A	rạ
RN-ANK	rạc
RN-AGK	rạch
RN-AT	rạm
RN-AN	rạn
RN-AG	rạng
RN-AJK	rạo
RN-ATK	rạp
RN-ANT	rạt
RN-AJN	rạy
R-HSA	rả
R-HSAJ	rải
R-HSAG	rảng
R-HSAK	rảnh
R-HSAJK	rảo
R-HSAJG	rảu
R-HSAJN	rảy
R-S*ET	rấm
R-S*EN	rấn
R-S*ETK	rấp
R-S*ENT	rất
R-H*ET	rầm
R-H*EN	rần
R-H*EJG	rầu
R-H*EJN	rầy
R-HS*ET	rẩm
R-HS*EJN	rẩy
RN-S*ET	rẫm
RN-S*EJN	rẫy
RN*-ET	rậm
RN*-EN	rận
RN*-ETK	rập
RN*-ENT	rật
R-S*ANK	rắc
R-S*AT	rắm
R-S*AN	rắn
R-S*ATK	rắp
R-S*ANT	rắt
R-H*AT	rằm
R-H*AN	rằn
R-H*AG	rằng
RN*-ANK	rặc
RN*-AT	rặm
RN*-AN	rặn
RN*-AG	rặng
RN*-ANT	rặt
R-HSE	rẻ
R-HSEG	rẻng
R-HSEJK	rẻo
RN-SE	rẽ
R-SOE	rế
R-SOEGK	rếch
R-SOEN	rến
R-SOENT	rết
R-HOE	rề
R-HOEN	rền
R-HOEK	rềnh
R-HOEJG	rều
R-HSOE	rể
RN-SOE	rễ
RN-OE	rệ
RN-OEGK	rệch
RN-OEN	rện
RN-OETK	rệp
RN-OENT	rệt
RN-OEJG	rệu
R-HS*I	rỉ
R-HSIE	rỉa
R-HS*IK	rỉnh
RN*-I	rị
RN-IE	rịa
RN*-IGK	rịch
RN*-IN	rịn
RN*-ITK	rịp
RN*-INT	rịt
RN-O	rọ
RN-ONK	rọc
RN-OJ	rọi
RN-OT	rọm
RN-ONT	rọt
R-HSO	rỏ
R-HSOJ	rỏi
R-HSOT	rỏm
R-HSON	rỏn
R-SOANK	rốc
R-SOAJ	rối
R-SOAT	rốm
R-SOAN	rốn
R-SOAG	rống
R-SOANT	rốt
R-HOA	rồ
R-HOAJ	rồi
R-HOAG	rồng
R-HSOA	rổ
R-HSOAN	rổn
R-HSOAG	rổng
RN-SOA	rỗ
RN-SOAJ	rỗi
RN-SOAG	rỗng
RN-OA	rộ
RN-OANK	rộc
RN-OAT	rộm
RN-OAN	rộn
RN-OAG	rộng
RN-OATK	rộp
RN-OANT	rột
R-SOY	rớ
R-SOYT	rớm
R-SOYTK	rớp
R-SOYNT	rớt
R-HOY	rờ
R-HOYJ	rời
R-HOYT	rờm
R-HOYN	rờn
R-HSOY	rở
R-HSOYT	rởm
R-HSOYN	rởn
RN-SOY	rỡ
RN-SOYN	rỡn
RN-OY	rợ
RN-OYJ	rợi
RN-OYN	rợn
RN-OYTK	rợp
RN-UO	rụa
RN-IUNK	rục
RN-IUJ	rụi
RN-IUT	rụm
RN-IUG	rụng
RN-IUNT	rụt
R-HSIU	rủ
R-HSUO	rủa
R-HSIUJ	rủi
R-HSIUN	rủn
R-HSIUG	rủng
R-SEA	rứa
R-SUANK	rức
R-SUANT	rứt
R-HUAG	rừng
R-HSEA	rửa
R-HSUAG	rửng
RN-SEA	rữa
RN-EA	rựa
RN-UANK	rực
S-A	sa
S-AJ	sai
S-AT	sam
S-AN	san
S-AG	sang
S-AK	sanh
S-AJK	sao
S-AJG	sau
S-AJN	say
S-E	se
S-EN	sen
S-EJK	seo
S*-I	si
S*-IT	sim
S*-IN	sin
S*-IK	sinh
S-IEG	siêng
S-IEJG	siêu
S-SIENK	siếc
S-SIENT	siết
S-HSIET	siểm
S-O	so
S-U	soa
S-OJ	soi
S-ON	son
S-OG	song
S*-OG	soong
S-HUJ	soài
S-HUN	soàn
S-SUJ	soái
S-SUN	soán
S-SUNT	soát
SN-UN	soạn
SN-UG	soạng
SN-UNT	soạt
S-HSUJ	soải
S-HSUG	soảng
S-IU	su
S-IUJ	sui
S-IUT	sum
S-IUN	sun
S-IUG	sung
S-UY	suy
S-HSEYN	suyển
SN-SEYN	suyễn
S-UE	suê
S-UON	suôn
S-UOG	suông
S-SUY	suý
S-SUYNT	suýt
S-S*YNT	suất
S-SUOJ	suối
S-SUONT	suốt
S-HUOG	suồng
SN-UONT	suột
SN-UYNT	suỵt
S-HA	sà
S-HAJ	sài
S-HAT	sàm
S-HAN	sàn
S-HAG	sàng
S-HAK	sành
S-HAJK	sào
S-SA	sá
S-SANK	sác
S-SAGK	sách
S-SAJ	sái
S-SAT	sám
S-SAN	sán
S-SAG	sáng
S-SAK	sánh
S-SAJK	sáo
S-SATK	sáp
S-SANT	sát
S-SAJG	sáu
S*-ET	sâm
S*-EN	sân
S*-EJG	sâu
S*-EJN	sây
SN-SA	sã
SN-SAJ	sãi
S-HE	sè
S-HEJK	sèo
S-SENK	séc
S-SET	sém
S-SENT	sét
S-OE	sê
S-OEN	sên
S-OEK	sênh
S-OEJG	sêu
S-H*I	sì
S-H*IK	sình
S-S*IK	sính
S-S*INT	sít
S-HO	sò
S-HOJ	sòi
S-HOT	sòm
S-HON	sòn
S-HOG	sòng
S-SONK	sóc
S-SOJ	sói
S-SOT	sóm
S-SON	són
S-SOG	sóng
S-SONT	sót
S-OA	sô
S-OAJ	sôi
S-OAG	sông
SN-SOJ	sõi
SN-SOT	sõm
SN-SOG	sõng
S-HIU	sù
S-HIUJ	sùi
S-HIUT	sùm
S-HIUG	sùng
S-SIU	sú
S-SIUNK	súc
S-SIUN	sún
S-SIUG	súng
S-SIUTK	súp
S-SIUNT	sút
S*-AT	săm
S*-AN	săn
S*-AG	săng
SN-S*I	sĩ
SN-SIU	sũ
SN-SIUG	sũng
S-OY	sơ
S-OYT	sơm
S-OYN	sơn
S-UA	sư
S-EA	sưa
S-UAG	sưng
S-UAJG	sưu
S-EAG	sương
S-SEAG	sướng
S-SEANT	sướt
S-HEAN	sườn
S-HSEAJ	sưởi
SN-EAG	sượng
SN-EANT	sượt
SN-A	sạ
SN-AGK	sạch
SN-AT	sạm
SN-AN	sạn
SN-AJK	sạo
SN-ATK	sạp
SN-ANT	sạt
S-HSA	sả
S-HSAJ	sải
S-HSAN	sản
S-HSAG	sảng
S-HSAK	sảnh
S-HSAJK	sảo
S-HSAJN	sảy
S-S*ET	sấm
S-S*EN	sấn
S-S*ETK	sấp
S-S*ENT	sất
S-S*EJG	sấu
S-S*EJN	sấy
S-H*ET	sầm
S-H*EN	sần
S-H*EJG	sầu
S-H*EJN	sầy
S-HS*ET	sẩm
S-HS*EN	sẩn
S-HS*EJN	sẩy
SN-S*ET	sẫm
SN*-ET	sậm
SN*-ETK	sập
SN*-EJG	sậu
SN*-EJN	sậy
S-S*ANK	sắc
S-S*AT	sắm
S-S*AN	sắn
S-S*AG	sắng
S-S*ATK	sắp
S-S*ANT	sắt
S-H*AG	sằng
SN-S*AN	sẵn
SN*-ANK	sặc
SN*-AT	sặm
SN*-ANT	sặt
SN-E	sẹ
SN-EJK	sẹo
S-HSE	sẻ
S-HSEN	sẻn
SN-SE	sẽ
S-SOEN	sến
S-SOETK	sếp
S-SOEJG	sếu
S-HOE	sề
S-HOEN	sền
S-HOEJG	sều
S-HSOE	sể
S-HSOEK	sểnh
SN-OE	sệ
SN-OENT	sệt
S-HS*I	sỉ
S-HSIE	sỉa
SN*-I	sị
SN-IE	sịa
SN*-INT	sịt
SN-O	sọ
SN-ONK	sọc
SN-OT	sọm
SN-ONT	sọt
S-HSO	sỏ
S-HSOJ	sỏi
S-HSOT	sỏm
S-SOA	số
S-SOANK	sốc
S-SOAG	sống
S-SOATK	sốp
S-SOANT	sốt
S-HOA	sồ
S-HOAJ	sồi
S-HOAN	sồn
S-HOAG	sồng
S-HSOA	sổ
S-HSOAJ	sổi
S-HSOAG	sổng
SN-SOA	sỗ
SN-OA	sộ
SN-OATK	sộp
SN-OANT	sột
S-SOY	sớ
S-SOYJ	sới
S-SOYT	sớm
S-SOYN	sớn
S-SOYNT	sớt
S-HOY	sờ
S-HOYT	sờm
S-HOYN	sờn
S-HSOY	sở
S-HSOYJ	sởi
S-HSOYN	sởn
SN-SOY	sỡ
SN-OY	sợ
SN-OYJ	sợi
SN-IU	sụ
SN-UO	sụa
SN-IUNK	sục
SN-IUT	sụm
SN-IUN	sụn
SN-IUTK	sụp
SN-IUNT	sụt
S-HSUO	sủa
S-HSIUJ	sủi
S-HSIUG	sủng
S-SUA	sứ
S-SEA	sứa
S-SUANK	sức
S-SUANT	sứt
S-HUAG	sừng
S-HSUA	sử
S-HSEA	sửa
S-HSUAG	sửng
S-HSUAJG	sửu
SN-SEA	sữa
SN-SUAG	sững
SN-UA	sự
SN-UANK	sực
SN-UAG	sựng
T-A	ta
T-AJ	tai
T-AT	tam
T-AN	tan
T-AG	tang
T-AK	tanh
T-AJK	tao
T-AJG	tau
T-AJN	tay
T-E	te
T-ET	tem
T-EN	ten
T-EG	teng
T-EJK	teo
TH-A	tha
TH-AJ	thai
TH-AT	tham
TH-AN	than
TH-AG	thang
TH-AK	thanh
TH-AJK	thao
TH-AJG	thau
TH-AJN	thay
TH-E	the
TH-EN	then
TH-EJK	theo
TH*-I	thi
TH-IE	thia
TH*-IN	thin
TH*-IK	thinh
TH*-IJG	thiu
TH-IET	thiêm
TH-IEN	thiên
TH-IEG	thiêng
TH-IEJG	thiêu
TH-SIENK	thiếc
TH-SIETK	thiếp
TH-SIENT	thiết
TH-SIEJG	thiếu
TH-HIEN	thiền
TH-HIEG	thiềng
TH-HIEJG	thiều
TH-HSIET	thiểm
TH-HSIEN	thiển
TH-HSIEJG	thiểu
THN-IEN	thiện
THN-IETK	thiệp
THN-IENT	thiệt
THN-IEJG	thiệu
TH-O	tho
TH-U	thoa
TH-UJ	thoai
TH-UN	thoan
TH-UG	thoang
TH-OJ	thoi
TH-OT	thom
TH-ON	thon
TH-OG	thong
TH-HU	thoà
TH-SU	thoá
TH-SUJ	thoái
TH-SUN	thoán
TH-SUG	thoáng
TH-SUNT	thoát
THN-SU	thoã
TH*-UN	thoăn
THN-UJ	thoại
THN-UNT	thoạt
TH-HSU	thoả
TH-HSUJ	thoải
TH-HSUG	thoảng
TH-S*UG	thoắng
TH-S*UNT	thoắt
TH-IU	thu
TH-UO	thua
TH-IUJ	thui
TH-IUT	thum
TH-IUN	thun
TH-IUG	thung
TH-EYN	thuyên
TH-SEYNT	thuyết
TH-HEYN	thuyền
TH-UE	thuê
TH-UON	thuôn
TH-SUY	thuý
TH-S*YN	thuấn
TH-H*YN	thuần
THN-S*YN	thuẫn
THN*-YN	thuận
THN*-YNT	thuật
TH-SUE	thuế
TH-SUONK	thuốc
TH-SUON	thuốn
TH-HUON	thuồn
TH-HUOG	thuồng
TH-HSUOG	thuổng
THN-SUON	thuỗn
THN-UONK	thuộc
THN-UOT	thuộm
TH-HSY	thuở
TH-HUY	thuỳ
THN-UY	thuỵ
TH-HSUY	thuỷ
TH-HA	thà
TH-HAJ	thài
TH-HAK	thành
TH-HAJK	thào
TH-HAJN	thày
TH-SA	thá
TH-SANK	thác
TH-SAGK	thách
TH-SAJ	thái
TH-SAT	thám
TH-SAN	thán
TH-SAG	tháng
TH-SAK	thánh
TH-SAJK	tháo
TH-SATK	tháp
TH-SANT	thát
TH-SAJG	tháu
TH*-ET	thâm
TH*-EN	thân
TH*-EJG	thâu
TH*-EJN	thây
THN-SAJ	thãi
TH-HE	thè
TH-HET	thèm
TH-HEN	thèn
TH-HEJK	thèo
TH-SE	thé
TH-SETK	thép
TH-SENT	thét
TH-OE	thê
TH-OET	thêm
TH-OEK	thênh
TH-OEJG	thêu
TH-H*I	thì
TH-HIE	thìa
TH-H*IN	thìn
TH-H*IK	thình
TH-H*IJG	thìu
TH-S*I	thí
TH-SIE	thía
TH-S*IGK	thích
TH-S*IT	thím
TH-S*IN	thín
TH-S*IK	thính
TH-S*INT	thít
TH-HO	thò
TH-HOJ	thòi
TH-HOT	thòm
TH-HOG	thòng
TH-SO	thó
TH-SONK	thóc
TH-SOJ	thói
TH-SOT	thóm
TH-SOTK	thóp
TH-SONT	thót
TH-OA	thô
TH-OAJ	thôi
TH-OAN	thôn
TH-OAG	thông
THN-SOT	thõm
THN-SOG	thõng
TH-HIU	thù
TH-HUO	thùa
TH-HIUJ	thùi
TH-HIUT	thùm
TH-HIUG	thùng
TH-SIU	thú
TH-SIUNK	thúc
TH-SIUJ	thúi
TH-SIUG	thúng
TH-SIUNT	thút
TH*-AT	thăm
TH*-AN	thăn
TH*-AG	thăng
THN-S*I	thĩ
THN-SIUG	thũng
TH-OY	thơ
TH-OYJ	thơi
TH-OYT	thơm
TH-OYN	thơn
TH-UA	thư
TH-EA	thưa
TH-UAG	thưng
TH-EAG	thương
TH-SEANK	thước
TH-SEANT	thướt
TH-HEAN	thườn
TH-HEAG	thường
TH-HSEAG	thưởng
THN-SEAJ	thưỡi
THN-SEAN	thưỡn
THN-EANK	thược
THN-EAG	thượng
THN-EANT	thượt
THN-A	thạ
THN-ANK	thạc
THN-AGK	thạch
THN-AK	thạnh
THN-AJK	thạo
THN-ATK	thạp
TH-HSA	thả
TH-HSAJ	thải
TH-HSAT	thảm
TH-HSAN	thản
TH-HSAG	thảng
TH-HSAK	thảnh
TH-HSAJK	thảo
TH-HSAJN	thảy
TH-S*ET	thấm
TH-S*ETK	thấp
TH-S*ENT	thất
TH-S*EJG	thấu
TH-S*EJN	thấy
TH-H*ET	thầm
TH-H*EN	thần
TH-H*EJG	thầu
TH-H*EJN	thầy
TH-HS*ET	thẩm
TH-HS*EN	thẩn
TH-HS*EJG	thẩu
THN-S*ET	thẫm
THN-S*EN	thẫn
THN*-ET	thậm
THN*-EN	thận
THN*-ETK	thập
THN*-ENT	thật
TH-S*ANK	thắc
TH-S*AT	thắm
TH-S*AN	thắn
TH-S*AG	thắng
TH-S*ATK	thắp
TH-S*ANT	thắt
TH-H*AN	thằn
TH-H*AG	thằng
TH-HS*AT	thẳm
TH-HS*AG	thẳng
THN*-AG	thặng
THN-EN	thẹn
THN-EJK	thẹo
TH-HSE	thẻ
TH-HSEJK	thẻo
THN-SE	thẽ
TH-SOE	thế
TH-SOEGK	thếch
TH-SOETK	thếp
TH-SOENT	thết
TH-HOE	thề
TH-HOET	thềm
TH-HOEJG	thều
TH-HSOE	thể
TH-HSOEJG	thểu
THN-OE	thệ
THN-OEN	thện
TH-HS*I	thỉ
TH-HS*IK	thỉnh
TH-HS*IJG	thỉu
THN*-I	thị
THN*-IGK	thịch
THN*-IK	thịnh
THN*-INT	thịt
THN-O	thọ
THN-ONK	thọc
THN-ONT	thọt
TH-HSO	thỏ
TH-HSOJ	thỏi
TH-HSOT	thỏm
TH-SOA	thố
TH-SOANK	thốc
TH-SOAJ	thối
TH-SOAN	thốn
TH-SOAG	thống
TH-SOANT	thốt
TH-HOA	thồ
TH-HOAT	thồm
TH-HOAN	thồn
TH-HSOA	thổ
TH-HSOAJ	thổi
TH-HSOAN	thổn
THN-SOAN	thỗn
THN-OANK	thộc
THN-OAN	thộn
THN-OATK	thộp
THN-OANT	thột
TH-SOY	thớ
TH-SOYJ	thới
TH-SOYT	thớm
TH-SOYNT	thớt
TH-HOY	thờ
TH-HOYJ	thời
TH-HSOY	thở
THN-OY	thợ
THN-IU	thụ
THN-IUNK	thục
THN-IUJ	thụi
THN-IUG	thụng
THN-IUTK	thụp
THN-IUNT	thụt
TH-HSIU	thủ
TH-HSUO	thủa
TH-HSIUJ	thủi
TH-HSIUT	thủm
TH-HSIUG	thủng
TH-SUA	thứ
TH-SUANK	thức
TH-HUA	thừ
TH-HEA	thừa
TH-HUAG	thừng
TH-HSUA	thử
TH-HSEA	thửa
THN-SUAG	thững
THN-UA	thự
THN-UANK	thực
T*-I	ti
T-IE	tia
T*-IT	tim
T*-IN	tin
T*-IK	tinh
T*-IJG	tiu
T-IET	tiêm
T-IEN	tiên
T-IEG	tiêng
T-IEJG	tiêu
T-SIENK	tiếc
T-SIET	tiếm
T-SIEN	tiến
T-SIEG	tiếng
T-SIETK	tiếp
T-SIENT	tiết
T-SIEJG	tiếu
T-HIET	tiềm
T-HIEN	tiền
T-HIEJG	tiều
T-HSIEJG	tiểu
TN-SIEN	tiễn
TN-SIEJG	tiễu
TN-IENK	tiệc
TN-IET	tiệm
TN-IEN	tiện
TN-IETK	tiệp
TN-IENT	tiệt
T-O	to
T-U	toa
T-UN	toan
T-UG	toang
T-UK	toanh
T-AY	toe
T-AYN	toen
T-OJ	toi
T-OT	tom
T-ON	ton
T-OG	tong
T*-OG	toong
T-HU	toà
T-HUJ	toài
T-HUN	toàn
T-HUG	toàng
T-SU	toá
T-SUNK	toác
T-SUJ	toái
T-SUN	toán
T-SUG	toáng
T-SUNT	toát
T-SUJN	toáy
T-HAY	toè
T-HAYN	toèn
T-SAY	toé
T-SAYNT	toét
TN-U	toạ
TN-UNK	toạc
TN-UJ	toại
TN-UG	toạng
T-HSU	toả
T-HSUN	toản
TN-AYNT	toẹt
T-HSAY	toẻ
TN-SAY	toẽ
TR-A	tra
TR-AJ	trai
TR-AG	trang
TR-AK	tranh
TR-AJK	trao
TR-AJG	trau
TR-E	tre
TR-EJK	treo
TR*-I	tri
TR*-IK	trinh
TR-IEG	triêng
TR-SIENT	triết
TR-HIEN	triền
TR-HIEG	triềng
TR-HIEJG	triều
TR-HSIEN	triển
TRN-IEN	triện
TRN-IENT	triệt
TRN-IEJG	triệu
TR-O	tro
TR-OT	trom
TR-OG	trong
TR-IU	tru
TR-IUJ	trui
TR-IUG	trung
TR-UY	truy
TR-HEYN	truyền
TRN-EYN	truyện
TR*-YN	truân
TR-UOG	truông
TR-S*YNT	truất
TR-SUENT	truết
TR-HUOG	truồng
TRN-UY	truỵ
TR-HA	trà
TR-HAT	tràm
TR-HAN	tràn
TR-HAG	tràng
TR-HAK	trành
TR-HAJK	trào
TR-HAJG	tràu
TR-SA	trá
TR-SANK	trác
TR-SAGK	trách
TR-SAJ	trái
TR-SAT	trám
TR-SAN	trán
TR-SAG	tráng
TR-SAK	tránh
TR-SAJK	tráo
TR-SATK	tráp
TR-SANT	trát
TR*-ET	trâm
TR*-EN	trân
TR*-EG	trâng
TR*-EJG	trâu
TR*-EJN	trây
TRN-SA	trã
TRN-SAJ	trãi
TR-HET	trèm
TR-HEJK	trèo
TR-SEJK	tréo
TR-SENT	trét
TR-OE	trê
TR-OEN	trên
TR-OEJG	trêu
TR-H*I	trì
TR-H*IK	trình
TR-H*IJG	trìu
TR-S*I	trí
TR-S*IGK	trích
TR-S*INT	trít
TR-S*IJG	tríu
TR-HO	trò
TR-HOJ	tròi
TR-HOT	tròm
TR-HON	tròn
TR-HOG	tròng
TR-SONK	tróc
TR-SOJ	trói
TR-SOT	tróm
TR-SOG	tróng
TR-SONT	trót
TR-OA	trô
TR-OAJ	trôi
TR-OAT	trôm
TR-OAN	trôn
TR-OAG	trông
TRN-SOT	trõm
TR-HIU	trù
TR-HIUJ	trùi
TR-HIUT	trùm
TR-HIUN	trùn
TR-HIUG	trùng
TR-SIU	trú
TR-SIUNK	trúc
TR-SIUT	trúm
TR-SIUG	trúng
TR-SIUNT	trút
TR*-AT	trăm
TR*-AN	trăn
TR*-AG	trăng
TRN-S*I	trĩ
TRN-S*IK	trĩnh
TRN-S*IJG	trĩu
TRN-SIUJ	trũi
TRN-SIUG	trũng
TR-OY	trơ
TR-OYJ	trơi
TR-OYN	trơn
TR-EA	trưa
TR-UAG	trưng
TR-EAG	trương
TR-SEANK	trước
TR-SEAG	trướng
TR-HEAN	trườn
TR-HEAG	trường
TR-HSEAG	trưởng
TRN-SEAG	trưỡng
TRN-EAG	trượng
TRN-EANT	trượt
TRN-A	trạ
TRN-ANK	trạc
TRN-AGK	trạch
TRN-AJ	trại
TRN-AT	trạm
TRN-AG	trạng
TRN-AK	trạnh
TRN-AJK	trạo
TRN-ANT	trạt
TR-HSA	trả
TR-HSAJ	trải
TR-HSAT	trảm
TR-HSAG	trảng
TR-HSAJK	trảo
TR-HSAJG	trảu
TR-HSAJN	trảy
TR-S*EN	trấn
TR-S*ETK	trấp
TR-S*EJG	trấu
TR-H*ET	trầm
TR-H*EN	trần
TR-H*EJG	trầu
TR-H*EJN	trầy
TR-HS*ET	trẩm
TR-HS*EJG	trẩu
TR-HS*EJN	trẩy
TRN-S*ET	trẫm
TRN*-ET	trậm
TRN*-EN	trận
TRN*-ETK	trập
TRN*-ENT	trật
TR-S*ANK	trắc
TR-S*AT	trắm
TR-S*AG	trắng
TR-S*ANT	trắt
TR-H*AT	trằm
TR-H*AN	trằn
TRN*-ANK	trặc
TRN*-AN	trặn
TRN-E	trẹ
TRN-EJK	trẹo
TRN-ENT	trẹt
TR-HSE	trẻ
TR-HSEJK	trẻo
TRN-SE	trẽ
TRN-SEN	trẽn
TR-SOEK	trếnh
TR-SOENT	trết
TR-SOEJG	trếu
TR-HOE	trề
TR-HSOEN	trển
TRN-SOE	trễ
TRN-OE	trệ
TRN-OEGK	trệch
TRN-OENT	trệt
TRN-OEJG	trệu
TR-HSIE	trỉa
TRN*-I	trị
TRN-IE	trịa
TRN*-IGK	trịch
TRN*-IK	trịnh
TRN*-INT	trịt
TRN-O	trọ
TRN-ONK	trọc
TRN-OJ	trọi
TRN-OT	trọm
TRN-ON	trọn
TRN-OG	trọng
TRN-ONT	trọt
TR-HSO	trỏ
TR-HSOG	trỏng
TR-SOA	trố
TR-SOANK	trốc
TR-SOAJ	trối
TR-SOAN	trốn
TR-SOAG	trống
TR-SOANT	trốt
TR-HOA	trồ
TR-HOAJ	trồi
TR-HOAG	trồng
TR-HSOA	trổ
TR-HSOAJ	trổi
TR-HSOAG	trổng
TRN-SOA	trỗ
TRN-SOAJ	trỗi
TRN-OA	trộ
TRN-OAJ	trội
TRN-OAT	trộm
TRN-OAN	trộn
TRN-OAG	trộng
TR-SOY	trớ
TR-SOYN	trớn
TR-SOYNT	trớt
TR-HOY	trờ
TR-HOYJ	trời
TR-HSOY	trở
TRN-OY	trợ
TRN-OYN	trợn
TRN-OYNT	trợt
TRN-IU	trụ
TRN-UO	trụa
TRN-IUNK	trục
TRN-IUJ	trụi
TRN-IUT	trụm
TRN-IUG	trụng
TRN-IUNT	trụt
TR-HSIU	trủ
TR-SUA	trứ
TR-SUAG	trứng
TR-HUA	trừ
TR-HUAG	trừng
TR-HUAJG	trừu
TR-HSUAG	trửng
TRN-SUA	trữ
TRN-UA	trự
TRN-UANK	trực
T-IU	tu
T-UO	tua
T-IUJ	tui
T-IUT	tum
T-IUN	tun
T-IUG	tung
T-UY	tuy
T-EY	tuya
T-UYN	tuyn
T-EYN	tuyên
T-SEYN	tuyến
T-SEYNT	tuyết
T-HEYN	tuyền
T-HSEYN	tuyển
TN-EYNT	tuyệt
T*-YN	tuân
T-UON	tuôn
T-UOG	tuông
T-SUY	tuý
T-SUYTK	tuýp
T-SUYNT	tuýt
T-S*YN	tuấn
T-S*YNT	tuất
T-H*YN	tuần
TN-S*YN	tuẫn
T-SUE	tuế
T-SUEGK	tuếch
T-HUEN	tuền
T-HUEK	tuềnh
TN-UE	tuệ
T-SUONK	tuốc
T-SUON	tuốn
T-SUONT	tuốt
T-HUOJ	tuồi
T-HUON	tuồn
T-HUOG	tuồng
T-HSUOJ	tuổi
TN-UONK	tuộc
TN-UONT	tuột
T-HUY	tuỳ
TN-UY	tuỵ
T-HSUY	tuỷ
T-I	ty
T-HA	tà
T-HAJ	tài
T-HAT	tàm
T-HAN	tàn
T-HAG	tàng
T-HAK	tành
T-HAJK	tào
T-HAJG	tàu
T-HAJN	tày
T-SA	tá
T-SANK	tác
T-SAGK	tách
T-SAJ	tái
T-SAT	tám
T-SAN	tán
T-SAG	táng
T-SAK	tánh
T-SAJK	táo
T-SATK	táp
T-SANT	tát
T-SAJG	táu
T-SAJN	táy
T*-ET	tâm
T*-EN	tân
T*-EG	tâng
T*-EJG	tâu
T*-EJN	tây
TN-SA	tã
TN-SAJ	tãi
T-HE	tè
T-HET	tèm
T-HEJK	tèo
T-SE	té
T-SET	tém
T-SEJK	téo
T-SETK	tép
T-SENT	tét
T-OE	tê
T-OET	têm
T-OEN	tên
T-OEK	tênh
T-OEJG	têu
T-H*I	tì
T-H*IT	tìm
T-H*IK	tình
T-S*I	tí
T-SIE	tía
T-S*IGK	tích
T-S*IT	tím
T-S*IN	tín
T-S*IK	tính
T-S*ITK	típ
T-S*INT	tít
T-S*IJG	tíu
T-HO	tò
T-HOJ	tòi
T-HOT	tòm
T-HON	tòn
T-HOG	tòng
T-SO	tó
T-SONK	tóc
T-SOJ	tói
T-SOT	tóm
T-SOTK	tóp
T-SONT	tót
T-OA	tô
T-OAJ	tôi
T-OAT	tôm
T-OAN	tôn
T-OAG	tông
TN-SOT	tõm
T-HIU	tù
T-HIUT	tùm
T-HIUG	tùng
T-SIU	tú
T-SUO	túa
T-SIUNK	túc
T-SIUJ	túi
T-SIUT	túm
T-SIUG	túng
T-SIUTK	túp
T-SIUNT	tút
T-SI	tý
T*-AT	tăm
T*-AN	tăn
T*-AG	tăng
TN-S*I	tĩ
TN-S*IN	tĩn
TN-S*IK	tĩnh
TN-S*IJG	tĩu
TN-SIUT	tũm
TN-SIUN	tũn
T-OY	tơ
T-OYJ	tơi
T-UA	tư
T-EA	tưa
T-UAG	tưng
T-EAJ	tươi
T-EAT	tươm
T-EAG	tương
T-SEANK	tước
T-SEAJ	tưới
T-SEAG	tướng
T-SEATK	tướp
T-SEANT	tướt
T-HEAG	tường
T-HEAJG	tườu
T-HSEAJ	tưởi
T-HSEAG	tưởng
TN-EANK	tược
TN-EAG	tượng
TN-EANT	tượt
TN-A	tạ
TN-ANK	tạc
TN-AGK	tạch
TN-AJ	tại
TN-AT	tạm
TN-AN	tạn
TN-AG	tạng
TN-AK	tạnh
TN-AJK	tạo
TN-ATK	tạp
TN-ANT	tạt
T-HSA	tả
T-HSAJ	tải
T-HSAN	tản
T-HSAG	tảng
T-HSAJK	tảo
T-S*ENK	tấc
T-S*ET	tấm
T-S*EN	tấn
T-S*ETK	tấp
T-S*ENT	tất
T-S*EJG	tấu
T-S*EJN	tấy
T-H*ET	tầm
T-H*EN	tần
T-H*EG	tầng
T-H*EJG	tầu
T-H*EJN	tầy
T-HS*ET	tẩm
T-HS*EN	tẩn
T-HS*EJG	tẩu
T-HS*EJN	tẩy
TN*-ET	tậm
TN*-EN	tận
TN*-ETK	tập
TN*-ENT	tật
TN*-EJG	tậu
T-S*ANK	tắc
T-S*AT	tắm
T-S*AN	tắn
T-S*ATK	tắp
T-S*ANT	tắt
T-H*AT	tằm
T-H*AN	tằn
T-H*AG	tằng
T-HS*AN	tẳn
TN*-ANK	tặc
TN*-AN	tặn
TN*-AG	tặng
TN-EJK	tẹo
TN-ETK	tẹp
TN-ENT	tẹt
T-HSE	tẻ
T-HSEJK	tẻo
TN-SE	tẽ
TN-SEN	tẽn
T-SOE	tế
T-SOEGK	tếch
T-SOENT	tết
T-SOEJG	tếu
T-HOE	tề
T-HSOE	tể
T-HSOEK	tểnh
TN-SOE	tễ
TN-SOEK	tễnh
TN-OE	tệ
TN-OETK	tệp
T-HS*I	tỉ
T-HSIE	tỉa
T-HS*IT	tỉm
T-HS*IK	tỉnh
TN*-I	tị
TN*-IGK	tịch
TN*-IK	tịnh
TN*-INT	tịt
TN*-IJG	tịu
TN-ONK	tọc
TN-OG	tọng
TN-OTK	tọp
TN-ONT	tọt
T-HSO	tỏ
T-HSOJ	tỏi
T-HSOG	tỏng
T-SOA	tố
T-SOANK	tốc
T-SOAJ	tối
T-SOAN	tốn
T-SOAG	tống
T-SOATK	tốp
T-SOANT	tốt
T-HOA	tồ
T-HOAJ	tồi
T-HOAN	tồn
T-HOAG	tồng
T-HSOA	tổ
T-HSOAN	tổn
T-HSOAG	tổng
TN-OA	tộ
TN-OANK	tộc
TN-OAJ	tội
TN-OANT	tột
T-SOY	tớ
T-SOYJ	tới
T-SOYN	tớn
T-SOYTK	tớp
T-HOY	tờ
T-HOYJ	tời
T-HSOY	tở
T-HSOYT	tởm
T-HSOYN	tởn
TN-SOYN	tỡn
TN-OY	tợ
TN-OYN	tợn
TN-OYTK	tợp
TN-IU	tụ
TN-IUNK	tục
TN-IUJ	tụi
TN-IUT	tụm
TN-IUG	tụng
TN-IUNT	tụt
T-HSIU	tủ
T-HSUO	tủa
T-HSIUJ	tủi
T-HSIUT	tủm
T-HSIUN	tủn
T-SUA	tứ
T-SEA	tứa
T-SUANK	tức
T-HUA	từ
T-HUAG	từng
T-HSUA	tử
T-HSUAJG	tửu
TN-UA	tự
TN-EA	tựa
TN-UAJG	tựu
T-HI	tỳ
T-HSI	tỷ
-IU	u
-IUJ	ui
-IUT	um
-IUN	un
-IUG	ung
-UY	uy
-EYN	uyên
-HSEYN	uyển
-UOT	uôm
-SUY	uý
-S*YNT	uất
-HS*YN	uẩn
-SUE	uế
-HSUE	uể
-SUON	uốn
-SUOG	uống
-SUONT	uốt
-HSUOG	uổng
N-UONT	uột
-HUYK	uỳnh
N-UYGK	uỵch
-HSUY	uỷ
TKH-A	va
TKH-AJ	vai
TKH-AT	vam
TKH-AN	van
TKH-AG	vang
TKH-AK	vanh
TKH-AJK	vao
TKH-AJN	vay
TKH-E	ve
TKH-EN	ven
TKH-EJK	veo
TKH*-I	vi
TKH*-IN	vin
TKH*-IK	vinh
TKH-IET	viêm
TKH-IEN	viên
TKH-SIEG	viếng
TKH-SIENT	viết
TKH-HIEN	viền
TKH-HSIEN	viển
TKHN-SIEN	viễn
TKHN-IENK	việc
TKHN-IEN	viện
TKHN-IENT	việt
TKH-O	vo
TKH-UN	voan
TKH-OJ	voi
TKH-ON	von
TKH-OG	vong
TKH-IU	vu
TKH-UO	vua
TKH-IUJ	vui
TKH-IUN	vun
TKH-IUG	vung
TKH-UOG	vuông
TKH-SUONT	vuốt
TKHN-UONT	vuột
TKH-HA	và
TKH-HAJ	vài
TKH-HAT	vàm
TKH-HAN	vàn
TKH-HAG	vàng
TKH-HAK	vành
TKH-HAJK	vào
TKH-HAJN	vày
TKH-SA	vá
TKH-SANK	vác
TKH-SAGK	vách
TKH-SAJ	vái
TKH-SAN	ván
TKH-SAG	váng
TKH-SAK	vánh
TKH-SAJK	váo
TKH-SATK	váp
TKH-SANT	vát
TKH-SAJN	váy
TKH*-ET	vâm
TKH*-EN	vân
TKH*-EG	vâng
TKH*-EJN	vây
TKHN-SA	vã
TKHN-SAJ	vãi
TKHN-SAN	vãn
TKHN-SAG	vãng
TKHN-SAK	vãnh
TKH-HE	vè
TKH-HEJK	vèo
TKH-SE	vé
TKH-SENK	véc
TKH-SEN	vén
TKH-SEJK	véo
TKH-SENT	vét
TKH-OE	vê
TKH-OEN	vên
TKH-OEK	vênh
TKH-OEJG	vêu
TKH-H*I	vì
TKH-S*I	ví
TKH-SIE	vía
TKH-S*IGK	vích
TKH-S*INT	vít
TKH-S*IJG	víu
TKH-HO	vò
TKH-HOJ	vòi
TKH-HOT	vòm
TKH-HON	vòn
TKH-HOG	vòng
TKH-SO	vó
TKH-SONK	vóc
TKH-SOJ	vói
TKH-SOT	vóm
TKH-SON	vón
TKH-SOG	vóng
TKH-SONT	vót
TKH-OA	vô
TKH-OAJ	vôi
TKH-OAN	vôn
TKH-OAG	vông
TKHN-SO	võ
TKHN-SOG	võng
TKH-HIU	vù
TKH-HUO	vùa
TKH-HIUJ	vùi
TKH-HIUN	vùn
TKH-HIUG	vùng
TKH-SIU	vú
TKH-SIUNK	vúc
TKH-SIUNT	vút
TKH*-AN	văn
TKH*-AG	văng
TKHN-S*I	vĩ
TKHN-S*IK	vĩnh
TKHN-SIU	vũ
TKHN-SIUT	vũm
TKHN-SIUG	vũng
TKH-OY	vơ
TKH-OYJ	vơi
TKH-EAN	vươn
TKH-EAG	vương
TKH-SEAG	vướng
TKH-HEAN	vườn
TKH-HSEAG	vưởng
TKHN-EANK	vược
TKHN-EAN	vượn
TKHN-EAG	vượng
TKHN-EANT	vượt
TKHN-A	vạ
TKHN-ANK	vạc
TKHN-AGK	vạch
TKHN-AJ	vại
TKHN-AT	vạm
TKHN-AN	vạn
TKHN-AG	vạng
TKHN-AK	vạnh
TKHN-ATK	vạp
TKHN-ANT	vạt
TKHN-AJN	vạy
TKH-HSA	vả
TKH-HSAJ	vải
TKH-HSAG	vảng
TKH-HSAK	vảnh
TKH-HSAJN	vảy
TKH-S*EN	vấn
TKH-S*ETK	vấp
TKH-S*ENT	vất
TKH-S*EJG	vấu
TKH-S*EJN	vấy
TKH-H*EN	vần
TKH-H*EG	vầng
TKH-H*EJG	vầu
TKH-H*EJN	vầy
TKH-HS*EN	vẩn
TKH-HS*EJG	vẩu
TKH-HS*EJN	vẩy
TKHN-S*EN	vẫn
TKHN-S*EJN	vẫy
TKHN*-ET	vậm
TKHN*-EN	vận
TKHN*-ETK	vập
TKHN*-ENT	vật
TKHN*-EJN	vậy
TKH-S*ANK	vắc
TKH-S*AN	vắn
TKH-S*AG	vắng
TKH-S*ANT	vắt
TKH-H*AT	vằm
TKH-H*AN	vằn
TKH-H*AG	vằng
TKH-HS*AG	vẳng
TKHN*-ANK	vặc
TKHN*-AN	vặn
TKHN*-ANT	vặt
TKHN-ENK	vẹc
TKHN-ET	vẹm
TKHN-EN	vẹn
TKHN-EJK	vẹo
TKHN-ENT	vẹt
TKH-HSE	vẻ
TKH-HSEN	vẻn
TKH-HSEJK	vẻo
TKHN-SE	vẽ
TKHN-SEN	vẽn
TKH-SOE	vế
TKH-SOEGK	vếch
TKH-SOENT	vết
TKH-SOEJG	vếu
TKH-HOE	về
TKH-HOEN	vền
TKH-HOEJG	vều
TKH-HSOEK	vểnh
TKHN-OE	vệ
TKHN-OEN	vện
TKHN-OENT	vệt
TKH-HS*I	vỉ
TKH-HSIE	vỉa
TKHN*-I	vị
TKHN*-IT	vịm
TKHN*-IN	vịn
TKHN*-IK	vịnh
TKHN*-INT	vịt
TKHN-O	vọ
TKHN-ONK	vọc
TKHN-OJ	vọi
TKHN-OT	vọm
TKHN-OG	vọng
TKHN-OTK	vọp
TKHN-ONT	vọt
TKH-HSO	vỏ
TKH-HSON	vỏn
TKH-HSOG	vỏng
TKH-SOA	vố
TKH-SOANK	vốc
TKH-SOAJ	vối
TKH-SOAN	vốn
TKH-SOAG	vống
TKH-HOA	vồ
TKH-HOAN	vồn
TKH-HOAG	vồng
TKH-HSOA	vổ
TKH-HSOAG	vổng
TKHN-SOA	vỗ
TKHN-OAJ	vội
TKH-SOY	vớ
TKH-SOYJ	với
TKH-SOYNT	vớt
TKH-HOY	vờ
TKH-HOYJ	vời
TKH-HOYN	vờn
TKH-HSOY	vở
TKH-HSOYN	vởn
TKHN-SOY	vỡ
TKHN-OY	vợ
TKHN-OYJ	vợi
TKHN-OYNT	vợt
TKHN-IU	vụ
TKHN-IUNK	vục
TKHN-IUN	vụn
TKHN-IUG	vụng
TKHN-IUNT	vụt
TKH-SUANK	vức
TKH-SUANT	vứt
TKH-HEA	vừa
TKH-HUAG	vừng
TKH-HSUAG	vửng
TKHN-SEA	vữa
TKHN-SUAG	vững
TKHN-EA	vựa
TKHN-UANK	vực
TKHN-UAG	vựng
ST-A	xa
ST-AT	xam
ST-AN	xan
ST-AG	xang
ST-AK	xanh
ST-AJK	xao
ST-AJN	xay
ST-E	xe
ST-ET	xem
ST-EN	xen
ST-EJK	xeo
ST*-I	xi
ST*-IT	xim
ST*-IN	xin
ST*-IK	xinh
ST-IET	xiêm
ST-IEN	xiên
ST-IEJG	xiêu
ST-SIENK	xiếc
ST-SIENT	xiết
ST-HIEG	xiềng
ST-HSIET	xiểm
ST-HSIEG	xiểng
ST-O	xo
ST-U	xoa
ST-UJ	xoai
ST-UN	xoan
ST-UG	xoang
ST-UJN	xoay
ST-AY	xoe
ST-AYN	xoen
ST-OJ	xoi
ST-OT	xom
ST-ON	xon
ST-OG	xong
ST*-OG	xoong
ST-HU	xoà
ST-HUJ	xoài
ST-HUT	xoàm
ST-HUN	xoàn
ST-HUG	xoàng
ST-HUK	xoành
ST-SU	xoá
ST-SUNK	xoác
ST-SUNT	xoát
ST-SUJN	xoáy
STN-SU	xoã
STN-SUJ	xoãi
ST-HAY	xoè
ST-HAYN	xoèn
ST-HAYG	xoèng
ST-SAY	xoé
ST-SAYG	xoéng
ST-SAYNT	xoét
ST*-UN	xoăn
STN-UNK	xoạc
STN-UGK	xoạch
STN-UK	xoạnh
STN-UTK	xoạp
STN-UNT	xoạt
ST-HSU	xoả
ST-HSUJ	xoải
ST-HSUG	xoảng
ST-S*UN	xoắn
ST-HS*UN	xoẳn
STN-AYNT	xoẹt
ST-IU	xu
ST-UO	xua
ST-IUJ	xui
ST-IUT	xum
ST-IUN	xun
ST-IUG	xung
ST-EY	xuya
ST-EYN	xuyên
ST-SEYN	xuyến
ST-SEYNT	xuyết
ST*-YN	xuân
ST-UE	xuê
ST-UOJ	xuôi
ST-UOG	xuông
ST-SUY	xuý
ST-SUYNT	xuýt
ST-S*YNT	xuất
ST-HS*YN	xuẩn
ST-HUE	xuề
ST-HUEK	xuềnh
ST-HSUE	xuể
STN-UEGK	xuệch
ST-SUOG	xuống
ST-HUOG	xuồng
ST-HSUOG	xuổng
STN-UOT	xuộm
ST-HUY	xuỳ
STN-UYNT	xuỵt
ST-HA	xà
ST-HAJ	xài
ST-HAT	xàm
ST-HAG	xàng
ST-HAJK	xào
ST-HAJG	xàu
ST-SA	xá
ST-SANK	xác
ST-SAGK	xách
ST-SAJ	xái
ST-SAT	xám
ST-SAN	xán
ST-SAG	xáng
ST-SAJK	xáo
ST-SATK	xáp
ST-SANT	xát
ST-SAJN	xáy
ST*-ET	xâm
ST*-EJG	xâu
ST*-EJN	xây
STN-SA	xã
STN-SAJK	xão
ST-HE	xè
ST-HEN	xèn
ST-HEG	xèng
ST-HEJK	xèo
ST-SE	xé
ST-SEN	xén
ST-SEJK	xéo
ST-SETK	xép
ST-SENT	xét
ST-OE	xê
ST-OEN	xên
ST-OEK	xênh
ST-OEJG	xêu
ST-H*I	xì
ST-HIE	xìa
ST-H*IK	xình
ST-H*IJG	xìu
ST-S*I	xí
ST-SIE	xía
ST-S*IGK	xích
ST-S*IK	xính
ST-S*INT	xít
ST-S*IJG	xíu
ST-SO	xó
ST-SONK	xóc
ST-SOJ	xói
ST-SOT	xóm
ST-SON	xón
ST-SONT	xót
ST-OA	xô
ST-OAJ	xôi
ST-OAT	xôm
ST-OAN	xôn
ST-OAG	xông
STN-SOG	xõng
ST-HIU	xù
ST-HIUJ	xùi
ST-HIUT	xùm
ST-HIUG	xùng
ST-SIU	xú
ST-SIUNK	xúc
ST-SIUJ	xúi
ST-SIUT	xúm
ST-SIUG	xúng
ST-SIUTK	xúp
ST-SIUNT	xút
ST*-AT	xăm
ST*-AN	xăn
ST*-AG	xăng
STN-S*IK	xĩnh
STN-SIU	xũ
ST-OY	xơ
ST-OYJ	xơi
ST-OYT	xơm
ST-OYN	xơn
ST-EA	xưa
ST-UAG	xưng
ST-EAG	xương
ST-SEANK	xước
ST-SEAG	xướng
ST-HEAG	xường
ST-HSEAG	xưởng
STN-EANK	xược
STN-A	xạ
STN-ANK	xạc
STN-AGK	xạch
STN-AT	xạm
STN-AJK	xạo
STN-ATK	xạp
ST-HSA	xả
ST-HSAJ	xải
ST-HSAT	xảm
ST-HSAJK	xảo
ST-HSAJG	xảu
ST-HSAJN	xảy
ST-S*ENK	xấc
ST-S*ETK	xấp
ST-S*EJG	xấu
ST-H*ET	xầm
ST-H*EJG	xầu
ST-HS*ET	xẩm
ST-HS*EN	xẩn
ST-HS*EJG	xẩu
ST-HS*EJN	xẩy
STN*-ET	xậm
STN*-ETK	xập
ST-S*ANK	xắc
ST-S*AT	xắm
ST-S*AN	xắn
ST-S*ATK	xắp
ST-S*ANT	xắt
ST-H*AG	xằng
STN-S*AG	xẵng
STN-EJK	xẹo
STN-ETK	xẹp
STN-ENT	xẹt
ST-HSE	xẻ
ST-HSEN	xẻn
ST-HSEG	xẻng
ST-HSEJK	xẻo
STN-SEJK	xẽo
ST-SOE	xế
ST-SOEGK	xếch
ST-SOETK	xếp
ST-HOE	xề
ST-HOET	xềm
ST-HOEK	xềnh
ST-HOEJG	xều
ST-HSOE	xể
ST-HSOEK	xểnh
STN-OE	xệ
STN-OEGK	xệch
STN-OETK	xệp
STN-OENT	xệt
ST-HS*I	xỉ
ST-HSIE	xỉa
ST-HS*IN	xỉn
ST-HS*IK	xỉnh
ST-HS*IJG	xỉu
STN*-I	xị
STN*-INT	xịt
STN*-IJG	xịu
STN-O	xọ
STN-ONK	xọc
STN-OT	xọm
STN-OTK	xọp
ST-HSO	xỏ
ST-SOA	xố
ST-SOANK	xốc
ST-SOAJ	xối
ST-SOAN	xốn
ST-SOAG	xống
ST-SOATK	xốp
ST-SOANT	xốt
ST-HOA	xồ
ST-HOAT	xồm
ST-HOAN	xồn
ST-HOAG	xồng
ST-HSOA	xổ
ST-HSOAJ	xổi
ST-HSOAT	xổm
ST-HSOAG	xổng
STN-OANK	xộc
STN-OAN	xộn
STN-OATK	xộp
ST-SOY	xớ
ST-SOYJ	xới
ST-SOYNT	xớt
ST-HOY	xờ
ST-HOYT	xờm
ST-HSOY	xở
ST-HSOYJ	xởi
STN-SOY	xỡ
STN-IU	xụ
STN-IUNK	xục
STN-IUJ	xụi
STN-IUTK	xụp
ST-HSIU	xủ
ST-HSIUJ	xủi
ST-HSIUG	xủng
ST-SUA	xứ
ST-SUANK	xức
ST-SUAG	xứng
ST-HUA	xừ
ST-HUAG	xừng
ST-HSUA	xử
ST-HSEA	xửa
ST-HSUAG	xửng
STN-UA	xự
STN-UANK	xực
-I	y
-IET	yêm
-IEN	yên
-IEG	yêng
-IEJG	yêu
-SIET	yếm
-SIEN	yến
-SIENT	yết
-SIEJG	yếu
-HSIET	yểm
-HSIEG	yểng
-HSIEJG	yểu
-HIUEA	{!}
-SIOEY	{"^}
N-H*IU	{#^}
-HIAWY	{$^}
-H*OEW	{&%}
N-HIOE	{'^}
-HOEAY	{(^}
N-SUOY	{,}
N-HIUW	{-|}
N-OEWY	{.}
N-HIOA	{:}
N*-IUA	{;}
-HS*IA	{?}
-H*IOA	{[^}
*-IOAW	{^ ^}
N-IUOE	{^ ^}{-|}
N*-UEW	{^!^}
N-UOEW	{^"^}
N-HSUO	{^"}
N-SIUO	{^'^}
N*-EWY	{^'}
N-HEAW	{^(^}
-SIAWY	{^)^}
*-IUOA	{^)}
N-SUOW	{^*^}
N-IOEA	{^+^}
N*-OEW	{^,^}
N-HIUY	{^-^}
-IUOEY	{^.^}
-S*IEW	{^/^}
-SIUOE	{^:^}
N-IUOA	{^;^}
N-HSOE	{^<^}
N-UEAY	{^=^}
N-S*EW	{^>^}
-H*UEA	{^>^}
N-HIUA	{^?^}
-S*IOA	{^@^}
-HIUOW	{^[^}
-HS*IW	{^\^}
-HIOAW	{^]^}
-H*IEA	{^]}
N-HSIE	{^^^}
-HS*OE	{^_^}
N-HOWY	{^`^}
-SUEAY	{^{^}
-IUEAW	{^|^}
-HSIEY	{^}^}
-S*UOE	{^}}
N-SUOE	{^~^}
N-SOEA	{^~}
-HIEWY	{{^}
-HA	à
-HAJK	ào
-SA	á
-SANK	ác
-SAGK	ách
-SAJ	ái
-SAT	ám
-SAN	án
-SAG	áng
-SAK	ánh
-SAJK	áo
-SATK	áp
-SANT	át
-SAJN	áy
*-ET	âm
*-EN	ân
*-EJG	âu
N-SA	ã
-HE	è
-HEJK	èo
-SE	é
-SENK	éc
-SET	ém
-SEN	én
-SEJK	éo
-SETK	ép
-SENT	ét
-OE	ê
-OET	êm
-OEJG	êu
-H*I	ì
-H*IN	ìn
-H*IK	ình
-S*I	í
-S*IGK	ích
-S*IN	ín
-S*INT	ít
-HO	ò
-HOJ	òi
-HOT	òm
-HOG	òng
-SO	ó
-SONK	óc
-SOJ	ói
-SOT	óm
-SOG	óng
-SOTK	óp
-SONT	ót
-OA	ô
-OAJ	ôi
-OAT	ôm
-OAN	ôn
-OAG	ông
N-SOT	õm
N-SOG	õng
-HIU	ù
-HUO	ùa
-HIUT	ùm
-HIUN	ùn
-HIUG	ùng
-SIU	ú
-SUO	úa
-SIUNK	úc
-SIUJ	úi
-SIUT	úm
-SIUG	úng
-SIUTK	úp
-SIUNT	út
-SI	ý
*-AT	ăm
*-AN	ăn
*-AG	ăng
STH-A	đa
STH-AJ	đai
STH-AT	đam
STH-AN	đan
STH-AG	đang
STH-AK	đanh
STH-AJK	đao
STH-AJG	đau
STH-AJN	đay
STH-E	đe
STH-ET	đem
STH-EN	đen
STH-EJK	đeo
STH*-I	đi
STH*-IN	đin
STH*-IK	đinh
STH*-IJG	điu
STH-IEN	điên
STH-IEG	điêng
STH-IEJG	điêu
STH-SIENK	điếc
STH-SIET	điếm
STH-SIEN	điến
STH-SIEG	điếng
STH-SIEJG	điếu
STH-HIET	điềm
STH-HIEN	điền
STH-HIEJG	điều
STH-HSIET	điểm
STH-HSIEN	điển
STH-HSIEJG	điểu
STHN-IET	điệm
STHN-IEN	điện
STHN-IETK	điệp
STHN-IEJG	điệu
STH-O	đo
STH-UN	đoan
STH-OT	đom
STH-ON	đon
STH-OG	đong
STH-HUJ	đoài
STH-HUN	đoàn
STH-HUG	đoàng
STH-HUK	đoành
STH-SU	đoá
STH-SUNK	đoác
STH-SUJ	đoái
STH-SUN	đoán
STHN-SUN	đoãn
STHN-U	đoạ
STHN-UN	đoạn
STHN-UNT	đoạt
STH-HSUN	đoản
STH-HSUG	đoảng
STH-IU	đu
STH-UO	đua
STH-IUJ	đui
STH-IUT	đum
STH-IUN	đun
STH-IUG	đung
STH-UOJ	đuôi
STH-HUEK	đuềnh
STH-HSUEK	đuểnh
STH-SUONK	đuốc
STH-SUOJ	đuối
STH-SUONT	đuốt
STH-HUON	đuồn
STH-HSUOJ	đuổi
STHN-SUON	đuỗn
STHN-UOJ	đuội
STHN-UONT	đuột
STH-HA	đà
STH-HAJ	đài
STH-HAT	đàm
STH-HAN	đàn
STH-HAG	đàng
STH-HAK	đành
STH-HAJK	đào
STH-HAJN	đày
STH-SA	đá
STH-SANK	đác
STH-SAGK	đách
STH-SAJ	đái
STH-SAT	đám
STH-SAN	đán
STH-SAG	đáng
STH-SAK	đánh
STH-SAJK	đáo
STH-SATK	đáp
STH-SANT	đát
STH-SAJG	đáu
STH-SAJN	đáy
STH*-ET	đâm
STH*-EJG	đâu
STH*-EJN	đây
STHN-SA	đã
STHN-SAJ	đãi
STHN-SAG	đãng
STHN-SAJN	đãy
STH-HE	đè
STH-HET	đèm
STH-HEN	đèn
STH-HEJK	đèo
STH-SE	đé
STH-SENK	đéc
STH-SET	đém
STH-SEJK	đéo
STH-SENT	đét
STH-OE	đê
STH-OET	đêm
STH-OEK	đênh
STH-OEJG	đêu
STH-H*I	đì
STH-HIE	đìa
STH-H*IK	đình
STH-H*IJG	đìu
STH-S*IGK	đích
STH-S*IK	đính
STH-S*INT	đít
STH-HO	đò
STH-HOJ	đòi
STH-HOT	đòm
STH-HON	đòn
STH-HOG	đòng
STH-SO	đó
STH-SOJ	đói
STH-SOT	đóm
STH-SON	đón
STH-SOG	đóng
STH-SONT	đót
STH-OA	đô
STH-OAJ	đôi
STH-OAT	đôm
STH-OAN	đôn
STH-OAG	đông
STHN-SO	đõ
STH-HIU	đù
STH-HUO	đùa
STH-HIUJ	đùi
STH-HIUT	đùm
STH-HIUN	đùn
STH-HIUG	đùng
STH-SIU	đú
STH-SUO	đúa
STH-SIUNK	đúc
STH-SIUT	đúm
STH-SIUG	đúng
STH-SIUTK	đúp
STH-SIUNT	đút
STH*-AT	đăm
STH*-AG	đăng
STHN-S*I	đĩ
STHN-SIE	đĩa
STHN-S*IK	đĩnh
STHN-SUO	đũa
STHN-SIUJ	đũi
STHN-SIUG	đũng
STH-OY	đơ
STH-OYT	đơm
STH-OYN	đơn
STH-EA	đưa
STH-UAG	đưng
STH-EAG	đương
STH-SEANK	đước
STH-HEAJ	đười
STH-HEAN	đườn
STH-HEAG	đường
STH-HSEAN	đưởn
STHN-SEAN	đưỡn
STHN-EANK	được
STHN-EAT	đượm
STHN-ANK	đạc
STHN-AGK	đạch
STHN-AJ	đại
STHN-AT	đạm
STHN-AN	đạn
STHN-AJK	đạo
STHN-ATK	đạp
STHN-ANT	đạt
STH-HSA	đả
STH-HSAT	đảm
STH-HSAN	đản
STH-HSAG	đảng
STH-HSAK	đảnh
STH-HSAJK	đảo
STH-HSAJN	đảy
STH-S*ET	đấm
STH-S*EG	đấng
STH-S*ENT	đất
STH-S*EJG	đấu
STH-S*EJN	đấy
STH-H*ET	đầm
STH-H*EN	đần
STH-H*EJG	đầu
STH-H*EJN	đầy
STH-HS*EJG	đẩu
STH-HS*EJN	đẩy
STHN-S*ET	đẫm
STHN-S*EN	đẫn
STHN-S*EJN	đẫy
STHN*-ET	đậm
STHN*-EN	đận
STHN*-ETK	đập
STHN*-ENT	đật
STHN*-EJG	đậu
STHN*-EJN	đậy
STH-S*ANK	đắc
STH-S*AT	đắm
STH-S*AN	đắn
STH-S*AG	đắng
STH-S*ATK	đắp
STH-S*ANT	đắt
STH-H*AT	đằm
STH-H*AN	đằn
STH-H*AG	đằng
STH-HS*AG	đẳng
STHN-S*AT	đẵm
STHN-S*AN	đẵn
STHN-S*AG	đẵng
STHN*-ANK	đặc
STHN*-AT	đặm
STHN*-AN	đặn
STHN*-AG	đặng
STHN*-ANT	đặt
STHN-EN	đẹn
STHN-ETK	đẹp
STHN-ENT	đẹt
STH-HSE	đẻ
STHN-SE	đẽ
STHN-SEJK	đẽo
STH-SOE	đế
STH-SOEGK	đếch
STH-SOET	đếm
STH-SOEN	đến
STH-SOEJG	đếu
STH-HOE	đề
STH-HOET	đềm
STH-HOEN	đền
STH-HOEK	đềnh
STH-HOEJG	đều
STH-HSOE	để
STH-HSOEK	đểnh
STH-HSOEJG	đểu
STHN-SOE	đễ
STHN-OE	đệ
STHN-OET	đệm
STHN-OETK	đệp
STHN-OENT	đệt
STH-HSIE	đỉa
STH-HS*IK	đỉnh
STHN-IE	địa
STHN*-IGK	địch
STHN*-IK	định
STHN*-INT	địt
STHN*-IJG	địu
STHN-O	đọ
STHN-ONK	đọc
STHN-OJ	đọi
STHN-OT	đọm
STHN-ON	đọn
STHN-OG	đọng
STHN-ONT	đọt
STH-HSO	đỏ
STH-HSOJ	đỏi
STH-HSOT	đỏm
STH-HSOG	đỏng
STH-SOA	đố
STH-SOANK	đốc
STH-SOAJ	đối
STH-SOAT	đốm
STH-SOAN	đốn
STH-SOAG	đống
STH-SOATK	đốp
STH-SOANT	đốt
STH-HOA	đồ
STH-HOAJ	đồi
STH-HOAT	đồm
STH-HOAN	đồn
STH-HOAG	đồng
STH-HSOA	đổ
STH-HSOAJ	đổi
STH-HSOAT	đổm
STH-HSOAG	đổng
STHN-SOA	đỗ
STHN-SOAJ	đỗi
STHN-OA	độ
STHN-OANK	độc
STHN-OAJ	đội
STHN-OAN	độn
STHN-OAG	động
STHN-OATK	độp
STHN-OANT	đột
STH-SOY	đớ
STH-SOYJ	đới
STH-SOYN	đớn
STH-SOYTK	đớp
STH-SOYNT	đớt
STH-HOY	đờ
STH-HOYJ	đời
STH-HOYT	đờm
STH-HOYN	đờn
STH-HSOYT	đởm
STH-HSOYN	đởn
STHN-SOY	đỡ
STHN-OY	đợ
STHN-OYJ	đợi
STHN-OYNT	đợt
STHN-IU	đụ
STHN-IUNK	đục
STHN-IUN	đụn
STHN-IUG	đụng
STHN-IUTK	đụp
STHN-IUNT	đụt
STH-HSIU	đủ
STH-HSIUJ	đủi
STH-HSIUG	đủng
STH-SUA	đứ
STH-SEA	đứa
STH-SUANK	đức
STH-SUAG	đứng
STH-SUANT	đứt
STH-HUA	đừ
STH-HUAG	đừng
STH-HSUA	đử
STHN-UANK	đực
STHN-UAG	đựng
N-S*I	ĩ
N-S*IJG	ĩu
-OY	ơ
-OYJ	ơi
-OYN	ơn
-UA	ư
-EA	ưa
-UAG	ưng
-UAJG	ưu
-EAJ	ươi
-EAT	ươm
-EAN	ươn
-EAG	ương
-SEANK	ước
-SEAT	ướm
-SEATK	ướp
-SEANT	ướt
-HEAN	ườn
-HSEAN	ưởn
N-SEAN	ưỡn
N-A	ạ
N-AGK	ạch
N-ANT	ạt
-HSA	ả
-HSAJ	ải
-HSAT	ảm
-HSAG	ảng
-HSAK	ảnh
-HSAJK	ảo
-S*ET	ấm
-S*EN	ấn
-S*ETK	ấp
-S*ENT	ất
-S*EJG	ấu
-S*EJN	ấy
-H*ET	ầm
-H*EG	ầng
-H*EJG	ầu
-HS*ET	ẩm
-HS*EN	ẩn
-HS*EJG	ẩu
-HS*EJN	ẩy
N-S*ET	ẫm
N-S*EJG	ẫu
N*-ET	ậm
N*-EG	ậng
N*-ETK	ập
N*-EJG	ậu
-S*ANK	ắc
-S*AG	ắng
-S*ATK	ắp
-S*ANT	ắt
-HS*AG	ẳng
N-S*AT	ẵm
N*-ANK	ặc
N-E	ẹ
N-ENK	ẹc
N-EJK	ẹo
N-ETK	ẹp
N-ENT	ẹt
-HSEN	ẻn
-HSEJK	ẻo
N-SEJK	ẽo
-SOE	ế
-SOEGK	ếch
-SOET	ếm
-SOENT	ết
-HOE	ề
-HOEK	ềnh
N-SOEK	ễnh
N-OEGK	ệch
-HS*I	ỉ
-HSIE	ỉa
-HS*IT	ỉm
-HS*IN	ỉn
-HS*IJG	ỉu
N*-I	ị
N*-IGK	ịch
N*-INT	ịt
N-O	ọ
N-ONK	ọc
N-OTK	ọp
-HSOJ	ỏi
-HSOT	ỏm
-HSON	ỏn
-HSOG	ỏng
-SOA	ố
-SOANK	ốc
-SOAJ	ối
-SOAT	ốm
-SOAG	ống
-SOATK	ốp
-SOANT	ốt
-HOA	ồ
-HOAJ	ồi
-HOAT	ồm
-HOAN	ồn
-HOAG	ồng
-HSOA	ổ
-HSOAJ	ổi
-HSOAT	ổm
-HSOAN	ổn
-HSOAG	ổng
N-OANK	ộc
N-OATK	ộp
-SOY	ớ
-SOYJ	ới
-SOYT	ớm
-SOYN	ớn
-SOYNT	ớt
-HOY	ờ
-HSOY	ở
-HSOYT	ởm
N-SOYT	ỡm
N-OY	ợ
N-OYNT	ợt
N-IU	ụ
N-IUNK	ục
N-IUTK	ụp
N-IUNT	ụt
-HSIU	ủ
-HSUO	ủa
-HSIUJ	ủi
-HSIUN	ủn
-HSIUG	ủng
-SUA	ứ
-SEA	ứa
-SUANK	ức
-SUAG	ứng
-HUA	ừ
-HEA	ừa
-HUAG	ừng
-HSUA	ử
-HSUAG	ửng
N-UA	ự
N-EA	ựa
N-UANK	ực
-HI	ỳ
-HSI	ỷ
